0,1,2,3,4,5,6,7,class
-412766,1075790,-662375,649,1619642,-996881,1465,130,0
125617,114716,-240333,0,148456,-311020,-1,124,1
135855,-107255,-27952,648,-1217875,-334109,-420,130,0
-943836,934084,13000,3248,1406818,16967,1884,130,0
-697477,244409,455017,1949,563900,1045478,627,130,0
34451,-135856,104653,3248,-1565180,1187500,-630,130,0
167706,185256,-351014,1948,864912,-1632212,417,130,0
1001037,-195658,-803431,1948,-302689,-1238612,-420,130,0
-138456,89053,51351,1948,1034166,578354,1046,130,0
-191758,-828132,1023788,3898,-1247410,1537110,-211,130,0
-481019,497268,-16251,-2,1439077,-49227,1255,130,0
-407566,-296412,705926,1948,-686442,1626764,208,130,0
601922,454367,-1056290,-1,699429,-1627603,627,130,0
-461518,-53953,515469,-2,-157314,1486837,628,130,0
558,-202,-355,1,-5853,-10279,1,124,1
101403,-137806,38351,1948,-1579215,426695,-421,130,0
-1073841,689025,387414,2598,1034376,578144,837,130,0
1083590,-489469,-593473,648,-737135,-893611,-211,130,0
51351,911984,-962037,1298,1375188,-1450599,1046,130,0
646,-188,-457,1,-357,-866,0,124,1
2310,-9491,7180,-1,-27119,20516,-1,124,1
330212,-53953,-276261,-2,-239637,-1279041,-2,130,0
961386,-687076,-274311,-1,-1134505,-450786,-631,130,0
-148206,919784,-772879,-1301,1521400,-1276108,1046,130,0
-1009488,824230,189157,3899,1252646,282788,1465,130,0
530419,137805,-669526,-1302,321331,-1547166,627,130,0
0,0,0,0,0,0,0,124,1
-976987,874932,105303,3248,1330361,156895,1466,130,0
235958,109854,-344513,1299,514255,-1599324,418,130,0
-303562,-3901,309411,1948,-16758,1422529,-1,130,0
-70492,40050,30441,-1,64081,48706,-1,124,1
665624,380914,-1047190,-652,585476,-1612731,627,130,0
-956836,874932,83853,1949,1348375,125474,1465,130,0
911334,-793030,-118955,-651,-1307529,-194601,-630,130,0
-200858,350363,-148856,649,1628021,-693774,836,130,0
438766,640273,-1078391,648,963155,-1623833,627,130,0
-564222,322412,242459,649,931734,696706,837,130,0
432266,98803,-531070,-1,287396,-1536064,-211,130,0
1082290,-582422,-500519,-651,-878319,-753264,-1,130,0
-662375,-398465,1066689,5849,-608519,1617338,626,130,0
-31852,-103354,137155,1949,-1181636,1567484,-420,130,0
-917835,137805,781329,1299,226858,1287628,836,130,0
-887284,64352,826180,3248,103688,1360106,836,130,0
0,0,0,0,0,0,0,124,1
9625,-2811,-6814,0,-8033,-19469,0,124,1
-483619,-11051,496618,1948,-33935,1431117,208,130,0
30000,30000,30000,90000,60000,60000,180000,124,1
-1077091,410165,668225,1299,616687,1001698,836,130,0
-549921,391964,157955,-2,1133037,452879,626,130,0
-156137,236390,-80252,1,305917,-103856,1,124,1
49401,-953586,908084,3899,-1449133,1377701,207,130,0
1067339,-642225,-425766,-652,-974677,-647900,-212,130,0
50051,-953586,907433,3898,-1449342,1377492,-1,130,0
-216,-344,560,0,-9943,16194,1,124,1
0,0,0,0,0,0,0,124,1
330,1025,-1355,0,11848,-15661,0,124,1
182813,-226626,43812,-1,-293281,56698,-1,124,1
54,86,-140,0,9943,-16194,-1,124,1
796929,-909385,113104,648,-1499197,187687,-421,130,0
-884,-4396,5281,1,-12694,15249,0,124,1
-40952,507018,-468018,-1952,1471545,-1350052,627,130,0
115704,230758,-344513,1949,1074175,-1602257,417,130,0
-797580,-233359,1036788,5849,-355057,1558476,626,130,0
-8440,8699,-259,0,24856,-740,0,124,1
254,404,-658,0,766,-1247,0,124,1
-20151,131304,-108555,2598,1525380,-1269196,1046,130,0
-182813,226626,-43812,1,293281,-56698,1,124,1
-469318,1080340,-611023,-1,1629278,-920633,1255,130,0
-1017289,772878,245709,1298,1189804,374746,836,130,0
-564222,1084890,-520020,648,1633468,-784476,1046,130,0
30000,30000,30000,90000,60000,60000,180000,124,1
700726,-439417,-260660,649,-1013010,-603491,-629,130,0
-898984,974386,-71503,3899,1467984,-112487,1256,130,0
430966,-1054990,626623,2599,-1624461,963783,-630,130,0
708526,-1070591,365313,3248,-1606656,546933,-211,130,0
0,0,0,0,0,0,0,124,1
37609,-224447,186838,0,-290462,241791,-1,124,1
-504,474,29,-1,13698,854,-1,124,1
30000,30000,30000,90000,60000,60000,180000,124,1
332,230,-562,0,6643,-16244,-1,124,1
-88404,-252860,342562,1298,-1162993,1574606,-420,130,0
143005,-81254,-59153,2598,-927965,-700268,-212,130,0
-531720,-136506,672125,3899,-317561,1546117,208,130,0
69840,-44499,-25340,1,-71199,-40544,1,124,1
-913935,963986,-47452,2599,1451226,-75201,1465,130,0
4301,-5332,1030,-1,-15397,2976,-1,124,1
-286011,1048489,-759879,2599,1580890,-1147073,836,130,0
30000,30000,30000,90000,60000,60000,180000,124,1
918,-1390,472,0,-16060,5452,0,124,1
656,-418,-238,0,-792,-451,0,124,1
563,-243,-320,0,-7032,-9251,0,124,1
330,-1355,1025,0,-15661,11848,0,124,1
377664,-1060840,687075,3899,-1611055,1041707,-211,130,0
-1052390,342562,715026,5198,519492,1081926,1256,130,0
566821,80603,-647425,-1,188525,-1498778,627,130,0
30000,30000,30000,90000,60000,60000,180000,124,1
900283,-976987,78002,1298,-1470080,117723,-421,130,0
-564872,324362,239858,-652,936342,691678,1045,130,0
-69840,44499,25340,-1,71199,40544,-1,124,1
662,-286,-376,0,-541,-712,1,124,1
879482,-995838,118954,2598,-1495635,178051,-420,130,0
-991938,824880,168356,1298,1269823,255766,1256,130,0
1017288,-186557,-831382,-651,-283836,-1250971,208,130,0
639623,-975687,337362,1298,-1608751,557616,-421,130,0
274960,-1024439,752078,2599,-1577749,1156079,-630,130,0
457,-516,59,0,-14922,1707,-1,124,1
313961,-1057590,746877,3248,-1589898,1121097,-630,130,0
135855,-30552,-104004,1299,-342907,-1211381,-1,130,0
1548,-9241,7693,0,-26405,21981,0,124,1
120904,-663675,544720,1949,-1532712,1255579,-211,130,0
516119,570071,-1084241,1949,857581,-1632421,418,130,0
-1006238,179406,832031,5199,271686,1259349,1046,130,0
354913,-183957,-170307,649,-840195,-793064,-420,130,0
-849582,-15601,867132,1949,-28070,1428603,836,130,0
0,1224,-1224,0,14145,-14145,0,124,1
169656,-1014038,847631,3249,-1524124,1271080,208,130,0
30000,30000,30000,90000,60000,60000,180000,124,1
-848282,1008187,-157306,2599,1519724,-240266,1046,130,0
-9414,7356,2058,0,21019,5880,0,124,1
1748,3785,-5533,0,10929,-15977,-1,124,1
1075140,-568122,-504419,2599,-864494,-767718,-1,130,0
-1084241,510919,575921,2599,768136,864703,1046,130,0
-33802,-287961,324362,2599,-1327848,1488093,-421,130,0
831,575,-1406,0,6643,-16244,-1,124,1
-1060190,579821,482318,1949,892353,739438,1465,130,0
-731278,1045239,-313312,649,1592201,-478227,1255,130,0
-178107,351663,-172257,1299,1633886,-801862,1045,130,0
-904834,-60453,971786,6499,-94682,1459605,627,130,0
1066689,-421216,-645475,-2,-639521,-981799,-211,130,0
-352314,1041339,-688376,649,1606027,-1062446,837,130,0
85803,810580,-897034,-651,1339368,-1479506,418,130,0
968536,-915885,-52002,649,-1374141,-78343,-629,130,0
1011437,-165757,-845682,-2,-250320,-1272338,-2,130,0
457617,-519370,61752,-1,-1496264,180355,-212,130,0
912634,-790430,-121555,649,-1304177,-199837,-420,130,0
-567472,-81254,651324,2598,-189783,1499824,627,130,0
109204,-133906,27301,2599,-1542138,303316,-420,130,0
53768,-66654,12885,-1,-106647,20617,0,124,1
-1065390,358813,711126,4549,536459,1068310,1046,130,0
592,-34,-557,1,-65,-1055,1,124,1
-537,-69,607,1,-131,1149,0,124,1
0,0,0,0,0,0,0,124,1
0,-8573,8573,0,-24494,24494,0,124,1
-568122,-81904,651324,1298,-191249,1500243,627,130,0
-910685,791079,120904,1298,1306271,196904,1046,130,0
710476,-1040039,330862,1299,-1599115,509018,-630,130,0
-209308,-481019,690975,648,-1110415,1592620,-630,130,0
-5226,738,4487,-1,2132,12958,0,124,1
30000,30000,30000,90000,60000,60000,180000,124,1
1080990,-635074,-445267,649,-956243,-668847,-211,130,0
205,-650,444,-1,-1231,842,-1,124,1
-395865,546670,-149506,1299,1581518,-434656,1255,130,0
-116355,-863883,985436,5198,-1315489,1496682,208,130,0
-801481,-230759,1036138,3898,-349610,1557010,1046,130,0
-865183,1001037,-134556,1298,1506527,-205284,1255,130,0
1344,-294,-1050,0,-3396,-12138,0,124,1
482,14,-497,-1,427,-14354,0,124,1
-706577,1036788,-329563,648,1599323,-509229,1254,130,0
109204,24050,-131305,1949,292004,-1537321,417,130,0
30000,30000,30000,90000,60000,60000,180000,124,1
378964,-1061490,686425,3899,-1611264,1040869,-211,130,0
925634,-958786,33801,649,-1439287,49854,-630,130,0
-390665,1070590,-679276,649,1614615,-1023903,1255,130,0
9777,-3547,-6229,1,-10136,-17799,1,124,1
-168357,1012737,-844382,-2,1524123,-1270871,627,130,0
-44,510,-466,0,14742,-13461,0,124,1
814480,-1032889,221008,2599,-1551146,331595,-2,130,0
194500,25130,-219631,-1,32521,-284228,0,124,1
728677,321112,-1048490,1299,487233,-1593250,417,130,0
143005,-81254,-59153,2598,-926289,-702153,-421,130,0
128704,-542121,412765,-652,-1563714,1191690,-629,130,0
-789780,1023788,-232059,1949,1559314,-356942,1046,130,0
77352,-338013,262609,1948,-1557849,1204886,-630,130,0
-4494,-5391,9885,0,-15404,28245,1,124,1
-956186,923684,35751,3249,1389641,49645,1046,130,0
108554,24050,-131305,1299,293261,-1537739,627,130,0
-891184,-53302,947735,3249,-85256,1455206,417,130,0
-360764,-345813,708526,1949,-800186,1633258,208,130,0
3059,6624,-9683,0,18925,-27666,-1,124,1
-542771,661724,-117005,1948,1532502,-275457,1046,130,0
-103,-516,620,1,-978,1175,1,124,1
300311,-1043940,747528,3899,-1585499,1134504,-420,130,0
-332,562,-230,0,16244,-6643,1,124,1
-505,-121,626,0,-229,1186,0,124,1
-5547,-58274,63822,1,-93239,102115,0,124,1
-110,1276,-1165,1,14742,-13461,0,124,1
-956186,876232,81253,1299,1350260,122122,1464,130,0
-533020,-135856,671475,2599,-315676,1545698,626,130,0
-72153,-67603,143655,3899,-776725,1632630,-1,130,0
-139,88,50,-1,10279,5853,-1,124,1
566821,-288611,-278861,-651,-828884,-804376,-421,130,0
856082,151455,-1004288,3249,224973,-1513231,417,130,0
-776,8935,-8158,1,25528,-23309,0,124,1
-201508,351013,-148206,1299,1627393,-689794,627,130,0
436816,643524,-1077741,2599,965878,-1623204,627,130,0
-1045890,276260,774829,5199,413289,1162363,1045,130,0
-4823,4971,-148,0,14354,-427,0,124,1
664,-332,-332,0,-629,-629,0,124,1
839831,139105,-978287,649,212614,-1508204,626,130,0
563,-320,-243,0,-9251,-7032,0,124,1
-221659,944485,-723478,-652,1562666,-1194204,1046,130,0
-932785,9100,928884,5199,11730,1408913,837,130,0
-289261,-31202,322412,1949,-142651,1480134,209,130,0
-525870,-461518,989337,1949,-762900,1632211,418,130,0
-1041990,783929,261309,3248,1178493,390876,1256,130,0
-880133,-109855,994537,4549,-166950,1490607,627,130,0
-170000,-62224,232224,0,-80525,300525,0,124,1
172906,-680576,508969,1299,-1571255,1172837,-630,130,0
30000,30000,30000,90000,60000,60000,180000,124,1
252859,-1041990,793029,3898,-1564971,1188966,-421,130,0
5818,-9845,4026,-1,-28129,11504,0,124,1
-1057590,312011,749478,3899,465867,1123192,837,130,0
142355,-62403,-77353,2599,-707390,-921471,-421,130,0
705926,247659,-954236,-651,407424,-1573350,-2,130,0
-299012,-265860,565521,649,-768765,1632420,208,130,0
828781,-1027689,201507,2599,-1541301,301012,-211,130,0
-189808,-163807,354913,1298,-753893,1631582,-212,130,0
1075,-1333,257,-1,-15397,2976,-1,124,1
457,-516,59,0,-14922,1707,-1,124,1
-598023,-27952,627923,1948,-64728,1445780,626,130,0
-98804,135855,-35752,1299,1580052,-430048,836,130,0
-1077741,436816,644824,3899,654811,968811,837,130,0
362713,344512,-706577,648,797253,-1632631,836,130,0
16507,-67798,51291,0,-108478,82066,-1,124,1
65002,-143006,78002,-2,-1631374,893819,-631,130,0
3999,-5464,1464,-1,-15777,4227,-1,124,1
-541,1402,-860,1,16194,-9943,1,124,1
-993888,875582,120254,1948,1317792,177842,1046,130,0
-27059,70105,-43045,1,112169,-68873,1,124,1
-569422,-516120,1089440,3898,-777563,1632839,208,130,0
-488169,1082940,-595423,-652,1631373,-895287,1255,130,0
441366,-989338,548620,648,-1630326,905131,-1,130,0
494668,592172,-1084891,1949,888164,-1630955,627,130,0
-1065390,419915,650024,4549,637006,984731,1256,130,0
53768,-66654,12885,-1,-106647,20617,0,124,1
182006,-354264,174856,2598,-1633887,803118,-420,130,0
-1069941,702026,369213,1298,1055113,553007,1255,130,0
39001,-956186,921084,3899,-1441801,1386499,208,130,0
914584,-967237,55252,2599,-1453741,81065,-630,130,0
449816,-1079691,633123,3248,-1625927,952472,-210,130,0
-938636,920434,20150,1948,1400953,28069,1465,130,0
1306,-1121,-184,1,-12958,-2132,0,124,1
30000,30000,30000,90000,60000,60000,180000,124,1
-1306,1121,184,-1,12958,2132,0,124,1
875582,-959436,85803,1949,-1476155,131758,-630,130,0
109204,-967237,860632,2599,-1491446,1323029,-1,130,0
12350,-128055,118304,2599,-1472384,1349004,-420,130,0
796279,-1026389,232058,1948,-1557849,351704,-421,130,0
-9751,126754,-115055,1948,1473849,-1346700,1255,130,0
674075,-1065390,394564,3249,-1615663,597206,-211,130,0
-872983,956835,-81904,1948,1475944,-130083,1674,130,0
-1396,889,506,-1,10279,5853,-1,124,1
-766379,1049789,-282111,1299,1579214,-426906,836,130,0
-656525,555120,101403,-2,1285743,230419,1046,130,0
-6429,-3304,9733,0,-9441,27810,0,124,1
1064739,-351014,-712427,1298,-531642,-1071872,-420,130,0
300961,751428,-1051740,649,1132618,-1585080,627,130,0
301,362,-663,0,685,-1256,0,124,1
-32502,-103354,137805,1949,-1181217,1567693,-2,130,0
-213208,-811881,1028988,3899,-1225416,1548422,418,130,0
-484269,-10401,496618,1948,-32469,1430488,417,130,0
41562,28760,-70323,-1,46016,-112517,-1,124,1
-636374,1079690,-443967,-651,1625298,-667799,1046,130,0
-113105,128054,-13001,1948,1493121,-171559,1255,130,0
30000,30000,30000,90000,60000,60000,180000,124,1
-531070,-137156,671475,3249,-319446,1546955,418,130,0
-1086841,563571,523919,649,847317,786150,1255,130,0
-364014,555770,-190458,1298,1608331,-553846,1046,130,0
0,0,0,0,0,0,0,124,1
239675,-136173,-103501,1,-176224,-133943,0,124,1
-544071,1083590,-539521,-2,1634096,-812755,1464,130,0
313311,656524,-969187,648,1083392,-1599953,627,130,0
-1032889,811230,223608,1949,1219131,332852,1256,130,0
-48752,-462818,513519,1949,-1338321,1480552,-1,130,0
-42902,-95554,139755,1299,-1089049,1598695,-630,130,0
-124155,118304,8450,2599,1373931,78552,837,130,0
-204988,-6293,211281,0,-8144,273423,0,124,1
-1058240,312661,749478,3899,466705,1122145,418,130,0
-22,132,-109,1,15249,-12694,0,124,1
-700727,1069290,-365964,2599,1608121,-552380,1255,130,0
68756,-48674,-20082,0,-77878,-32132,1,124,1
10400,-616874,609722,3248,-1425672,1403467,-420,130,0
48751,462167,-511570,-652,1340625,-1478668,627,130,0
68756,-48674,-20082,0,-77878,-32132,1,124,1
-664975,1060839,-393265,2599,1616291,-601397,1046,130,0
128054,-542121,413415,-652,-1562457,1194622,-420,130,0
-913285,963986,-48102,2599,1451645,-76458,1046,130,0
-707877,-245060,954235,1298,-406378,1573139,-2,130,0
-237456,86157,151298,-1,111497,195798,-1,124,1
85153,-141706,59152,2599,-1625299,668427,-211,130,0
753378,-1056940,305511,1949,-1587594,459164,-630,130,0
-873633,956835,-81254,1948,1475316,-128826,1256,130,0
-128055,348413,-218409,1949,1616081,-1015524,1046,130,0
-1053690,705926,352313,4549,1071871,532270,1256,130,0
-139106,50051,90353,1298,588408,1025578,836,130,0
-564222,323712,240509,-1,934038,694192,1255,130,0
588272,395214,-982837,649,650622,-1622366,418,130,0
65652,-143006,78002,648,-1631583,891306,-420,130,0
648724,-1053040,406915,2599,-1619853,624857,-839,130,0
0,0,0,0,0,0,0,124,1
287960,751428,-1038089,1299,1144139,-1581519,1046,130,0
57206,7391,-64597,0,11826,-103355,0,124,1
-1033539,768978,269760,5199,1168648,404701,1047,130,0
126754,-120255,-6501,-2,-1372675,-81276,-839,130,0
-237456,86157,151298,-1,111497,195798,-1,124,1
6999,-9562,2562,-1,-27320,7320,-1,124,1
-328913,50701,278860,648,237960,1280506,626,130,0
884,-5281,4396,-1,-15249,12694,0,124,1
0,0,0,0,0,0,0,124,1
-126,7,118,-1,854,13698,-1,124,1
114,-129,14,-1,-14922,1707,-1,124,1
-490119,1083590,-592173,1298,1631582,-891726,1045,130,0
-1002338,197607,806680,1949,301640,1239240,208,130,0
194500,-219631,25130,-1,-284228,32521,0,124,1
397814,-548621,151455,648,-1581100,434027,-420,130,0
1074490,-571372,-500519,2599,-869522,-762481,208,130,0
156137,80252,-236390,-1,103856,-305917,-1,124,1
-1344,294,1050,0,3396,12138,0,124,1
1060189,-578522,-479068,2599,-892354,-738601,-420,130,0
-890534,-90354,984786,3898,-138043,1478458,627,130,0
-302912,-728028,1032888,1948,-1123403,1588431,-421,130,0
668225,-1075141,409515,2599,-1618596,616268,-211,130,0
570721,516769,-1085541,1949,774839,-1632421,418,130,0
768978,282110,-1049790,1298,421249,-1576911,627,130,0
-52,-547,599,0,-1037,1136,1,124,1
-106604,131954,-24701,649,1541509,-301432,1046,130,0
755978,174206,-930835,-651,286139,-1535435,-1,130,0
-399,546,-146,1,15777,-4227,1,124,1
578521,-644175,66952,1298,-1485162,153124,-421,130,0
-112455,128054,-13001,2598,1495634,-177843,1255,130,0
1067339,-418616,-646775,1948,-637426,-983684,-420,130,0
258709,305511,-565522,-1302,883555,-1630955,417,130,0
11061,-66014,54952,-1,-105622,87924,0,124,1
-7801,614923,-607123,-1,1424623,-1404305,837,130,0
339312,724127,-1062790,649,1087372,-1599115,627,130,0
90353,249609,-339963,-1,1163830,-1574188,1046,130,0
-165107,-187858,355563,2598,-866380,1632420,-2,130,0
649374,-84504,-565522,-652,-192925,-1307948,-2,130,0
-8820,518,8302,0,1480,23721,0,124,1
771578,280160,-1049140,2598,417060,-1575864,208,130,0
43,-138,94,-1,-15977,10929,-1,124,1
5547,58274,-63822,-1,93239,-102115,0,124,1
1083590,-490119,-592823,648,-737973,-892983,-212,130,0
-662,376,286,0,712,541,-1,124,1
531719,-1076441,548620,3898,-1634097,831816,-1,130,0
0,0,0,0,0,0,0,124,1
-173557,678625,-504419,649,1573139,-1168230,1255,130,0
690325,-1073191,386114,3248,-1612731,579191,-421,130,0
898983,-963987,68252,3248,-1462748,101594,-1,130,0
-796930,906783,-110505,-652,1497939,-183289,1256,130,0
-130,18,112,0,2132,12958,0,124,1
0,0,0,0,0,0,0,124,1
30000,30000,30000,90000,60000,60000,180000,124,1
-219059,-341913,562271,1299,-987664,1620690,-1,130,0
451116,-1080341,632473,3248,-1626137,951424,-211,130,0
235308,111154,-344513,1949,518654,-1600372,-2,130,0
397164,-1075141,680575,2598,-1614825,1021807,-420,130,0
-297712,312661,-13001,1948,1449341,-71850,836,130,0
1077740,-430317,-646125,1298,-650413,-972373,-421,130,0
-369214,-186557,556420,649,-539183,1604979,208,130,0
-985437,104653,885983,5199,155009,1330989,836,130,0
999737,-195658,-803431,648,-301851,-1238822,-2,130,0
-759879,-169007,930834,1948,-281113,1533968,208,130,0
143655,-72153,-68903,2599,-819877,-813592,-420,130,0
1033538,-260660,-771579,1299,-396113,-1173885,209,130,0
61752,-969187,910684,3249,-1458349,1366809,-1,130,0
0,0,0,0,0,0,0,124,1
335412,226208,-562272,-652,655649,-1622995,417,130,0
709826,-1040689,332162,1299,-1599115,510275,-211,130,0
984786,-568122,-418616,-1952,-937391,-690004,-421,130,0
126,-118,-7,1,-13698,-854,1,124,1
738427,319811,-1056290,1948,478226,-1591365,417,130,0
-239675,103501,136173,-1,133943,176224,0,124,1
135855,-31202,-104004,649,-342488,-1211591,-2,130,0
30000,30000,30000,90000,60000,60000,180000,124,1
-1205,1242,-37,0,14354,-427,0,124,1
677325,396514,-1071241,2598,595111,-1614406,836,130,0
3788,6026,-9814,0,17218,-28042,-1,124,1
3325,-5625,2300,0,-16244,6643,-1,124,1
219708,-1019889,804730,4549,-1550517,1221644,-211,130,0
-898984,974386,-71503,3899,1467775,-111859,1256,130,0
705276,248309,-953586,-1,408262,-1573350,418,130,0
-222115,190735,31380,0,246833,40610,0,124,1
-120,124,-3,1,14354,-427,0,124,1
-598673,1080340,-482319,-652,1630744,-727499,1255,130,0
-563,243,320,0,7032,9251,0,124,1
987386,-434867,-553821,-1302,-717444,-911835,-210,130,0
30000,30000,30000,90000,60000,60000,180000,124,1
454367,-1080341,629873,3899,-1626765,946607,-210,130,0
0,0,0,0,0,0,0,124,1
30000,30000,30000,90000,60000,60000,180000,124,1
-139756,-841132,981536,648,-1296008,1509460,-1,130,0
174,378,-553,-1,10929,-15977,-1,124,1
30000,30000,30000,90000,60000,60000,180000,124,1
256109,-565522,310711,1298,-1630955,897171,-211,130,0
-666925,1060189,-391315,1949,1615872,-598673,1046,130,0
614,-86,-527,1,-164,-998,0,124,1
-750779,1053039,-300312,1948,1586755,-454347,1464,130,0
353613,-207358,-145606,649,-948283,-677854,-211,130,0
-784580,-240510,1030288,5198,-367625,1562247,627,130,0
451766,243759,-695527,-2,564947,-1609379,208,130,0
848931,15600,-864533,-2,24089,-1425881,418,130,0
827481,-1027689,203457,3249,-1542138,303735,-1,130,0
-337363,79302,260009,1948,369090,1193365,207,130,0
194500,25130,-219631,-1,32521,-284228,0,124,1
469967,-694227,227508,3248,-1602048,523053,-840,130,0
-1066690,420565,650024,3899,637215,984312,1255,130,0
-2568,-3080,5649,1,-8896,16311,0,124,1
-348414,225558,122204,-652,1051552,557197,1046,130,0
460867,54602,-514820,649,158570,-1486628,417,130,0
-3059,9683,-6624,0,27666,-18925,1,124,1
-566172,1084890,-518720,-2,1633258,-780496,1255,130,0
-1038739,712426,328262,1949,1096380,500639,837,130,0
970486,-913285,-55903,1298,-1371209,-83790,-631,130,0
700726,-438117,-261960,649,-1010497,-606005,-211,130,0
776,-8935,8158,-1,-25528,23309,0,124,1
0,0,0,0,0,0,0,124,1
934735,-6501,-924985,3249,-11521,-1408285,418,130,0
-1062140,330862,733877,2599,495821,1099941,627,130,0
-5379,4203,1176,0,12138,3396,0,124,1
-576572,1057589,-479718,1299,1631582,-741743,1046,130,0
142355,209957,-349064,3248,974466,-1621948,626,130,0
-722828,-323063,1051739,5848,-493518,1595134,-1,130,0
86453,894433,-980237,649,1345652,-1474479,1046,130,0
-297062,1040038,-743628,-652,1585708,-1133667,836,130,0
-563572,1084890,-520670,648,1633468,-785104,1256,130,0
192407,830081,-1020539,1949,1248666,-1536273,1465,130,0
-277561,701376,-421216,2599,1622575,-977610,1255,130,0
-4823,-148,4971,0,-427,14354,0,124,1
109204,24050,-131305,1949,291167,-1536902,627,130,0
-231409,1032888,-800831,648,1556801,-1207401,1046,130,0
1300,940585,-941886,-1,1413521,-1415407,1046,130,0
-1034189,810580,223608,-1,1218502,333689,1255,130,0
-376365,1056939,-679926,648,1611892,-1036471,1256,130,0
30000,30000,30000,90000,60000,60000,180000,124,1
-83,-57,140,0,-6643,16244,1,124,1
175506,-681226,507669,1949,-1572931,1168857,-840,130,0
-1062790,722177,343862,3249,1085906,514674,1674,130,0
-68756,20082,48674,0,32132,77878,-1,124,1
-705277,295761,410165,649,681624,944721,836,130,0
30000,30000,30000,90000,60000,60000,180000,124,1
-53302,-87104,141705,1299,-989968,1619852,-1,130,0
-573322,1058239,-483619,1298,1632211,-746980,1465,130,0
1035488,-230109,-804081,1298,-347935,-1207820,-2,130,0
-3673,-1888,5562,1,-5452,16060,0,124,1
11700,115054,-126105,649,1345652,-1474269,1046,130,0
-606473,-471918,1084240,5849,-714721,1629278,418,130,0
-298362,-266510,566171,1299,-770860,1632630,208,130,0
-323713,283410,41601,1298,1313812,184545,1255,130,0
566,17,-584,-1,32,-1106,-1,124,1
878182,-837232,-42252,-1302,-1379797,-67870,-840,130,0
385464,596072,-981537,-1,984102,-1620691,626,130,0
30000,30000,30000,90000,60000,60000,180000,124,1
100,36,-136,0,4227,-15777,0,124,1
-295,565,-269,1,16328,-7793,1,124,1
-1409,608,801,0,7032,9251,0,124,1
-495319,-589573,1087490,2598,-886908,1631373,208,130,0
380264,668225,-1045890,2599,1027882,-1612940,837,130,0
885983,-61103,-825531,-651,-102014,-1360526,-212,130,0
-606473,616223,-7801,1949,1426927,-24090,1464,130,0
563,-320,-243,0,-9251,-7032,0,124,1
30000,30000,30000,90000,60000,60000,180000,124,1
490768,-1086841,598672,2599,-1630955,897380,207,130,0
85153,-142356,59802,2599,-1625299,669265,-630,130,0
431,-653,221,-1,-1237,420,0,124,1
34451,-136506,104653,2598,-1565180,1187919,-630,130,0
0,0,0,0,0,0,0,124,1
-884,-4396,5281,1,-12694,15249,0,124,1
-48102,-463468,512869,1299,-1338531,1480343,-2,130,0
646774,-1053040,409515,3249,-1620481,629046,-630,130,0
0,0,0,0,0,0,0,124,1
0,0,0,0,0,0,0,124,1
967886,-112455,-856083,-652,-174072,-1319050,-1,130,0
41562,-70323,28760,-1,-112517,46016,-1,124,1
-48102,952285,-903534,649,1450598,-1375817,837,130,0
-347,664,-317,0,1258,-600,1,124,1
-200858,351013,-148856,1299,1627812,-692517,837,130,0
3900,486218,-492069,-1951,1409332,-1420016,627,130,0
-174207,-841782,1018588,2599,-1265844,1527265,208,130,0
-221,-1099,1320,0,-12694,15249,0,124,1
237456,-86157,-151298,1,-111497,-195798,1,124,1
2164,3443,-5608,-1,9943,-16194,-1,124,1
3999,-5464,1464,-1,-15777,4227,-1,124,1
-234009,-113105,348413,1299,-519074,1600580,-2,130,0
-1026389,823580,204107,1298,1238611,303525,1254,130,0
-153406,351663,-195658,2599,1629697,-913720,837,130,0
-605173,-472568,1083590,5849,-715559,1629488,628,130,0
30000,30000,30000,90000,60000,60000,180000,124,1
0,61237,-61237,0,97979,-97979,0,124,1
-884,5281,-4396,1,15249,-12694,0,124,1
-254160,563571,-308762,649,1630954,-895706,836,130,0
674075,-1065390,393914,2599,-1615663,596578,-210,130,0
-107255,965286,-859333,-1302,1490398,-1324706,1255,130,0
30000,30000,30000,90000,60000,60000,180000,124,1
410165,293811,-702027,1949,679319,-1625509,626,130,0
-667576,1060189,-390015,2598,1615662,-596788,1465,130,0
137155,405615,-544071,-1301,1176817,-1569160,1046,130,0
330862,-563572,234658,1948,-1626137,676177,-421,130,0
1375,-401,-973,1,-4639,-11243,0,124,1
-107,133,-25,1,15397,-2976,1,124,1
-73,141,-67,1,16328,-7793,1,124,1
-919135,137155,781329,-651,225811,1288047,627,130,0
194357,-1000388,807980,1949,-1539625,1242591,-421,130,0
110,1165,-1276,-1,13461,-14742,0,124,1
30000,30000,30000,90000,60000,60000,180000,124,1
24700,926934,-951636,-2,1395088,-1433422,837,130,0
-297712,-751429,1053689,4548,-1135342,1585079,-211,130,0
0,0,0,0,0,0,0,124,1
551220,-166407,-387415,-2602,-475294,-1115652,-420,130,0
335412,226208,-562272,-652,656487,-1622995,627,130,0
63052,269110,-330863,1299,1251180,-1535016,627,130,0
-117655,661074,-543421,-2,1531873,-1257465,1046,130,0
-646,188,457,-1,357,866,0,124,1
481018,-500519,18850,-651,-1442220,55929,-839,130,0
1078390,-433567,-642875,1948,-655441,-967974,-212,130,0
-969837,112454,860632,3249,170301,1321772,836,130,0
-980237,891183,93603,4549,1341253,137623,1465,130,0
354263,-158606,-194358,1299,-725823,-904504,-421,130,0
-53302,-86454,141055,1299,-992482,1619642,-421,130,0
353613,-206708,-145606,1299,-947027,-679320,-421,130,0
-132,-410,542,0,-11848,15661,0,124,1
-33802,-911985,950335,4548,-1386710,1441800,208,130,0
223608,-947086,725427,1949,-1562248,1195041,-630,130,0
891183,76702,-964637,3248,114581,-1467776,836,130,0
5639,-3204,-2435,0,-9251,-7032,0,124,1
-130655,986736,-856083,-2,1503804,-1304387,1255,130,0
-90354,-892484,985436,2598,-1341254,1478248,-2,130,0
430966,-1055640,627273,2599,-1624461,964202,-839,130,0
-558371,358813,198257,-1301,1037099,574793,628,130,0
219058,341262,-561622,-1302,988292,-1620062,418,130,0
369863,184606,-555771,-1302,535202,-1603723,208,130,0
294461,-566172,273010,1299,-1633469,786988,-421,130,0
558370,-358814,-200858,-1302,-1035215,-576888,-630,130,0
-798880,-232059,1036788,5849,-352543,1557638,417,130,0
-140406,60452,81253,1299,704666,923984,837,130,0
-32101,-38511,70613,1,-61618,112982,1,124,1
55902,-141706,87753,1949,-1619853,994366,-421,130,0
-60290,62141,-1850,1,99426,-2961,0,124,1
-7527,-1804,9331,0,-5154,26661,0,124,1
30000,30000,30000,90000,60000,60000,180000,124,1
32101,38511,-70613,-1,61618,-112982,-1,124,1
-969837,61752,912634,4549,90492,1367018,417,130,0
37609,-224447,186838,0,-290462,241791,-1,124,1
-5226,4487,738,-1,12958,2132,0,124,1
-91004,-46802,140405,2599,-538345,1604560,208,130,0
5547,-63822,58274,-1,-102115,93239,0,124,1
-482,-14,497,1,-427,14354,0,124,1
332,-562,230,0,-16244,6643,-1,124,1
664,-332,-332,0,-629,-629,0,124,1
119604,-663025,546020,2599,-1531246,1258511,-421,130,0
931484,-31202,-901584,-1302,-48808,-1389223,-2,130,0
798879,237258,-1033539,2598,355056,-1557849,837,130,0
34451,102053,-134556,1948,1184149,-1566228,1046,130,0
134,-105,-29,0,-12138,-3396,0,124,1
-8820,518,8302,0,1480,23721,0,124,1
-70710,35355,35355,0,56568,56568,-1,124,1
443,-5105,4661,-1,-14742,13461,0,124,1
22,109,-132,-1,12694,-15249,0,124,1
977636,-78653,-897684,1299,-120447,-1350261,-1,130,0
-642,-770,1412,0,-8896,16311,0,124,1
-140406,79302,62402,1298,930268,697962,836,130,0
-1065390,354263,715026,3899,530594,1072919,1256,130,0
-66303,887283,-821631,-651,1467146,-1356127,836,130,0
120904,-664325,544720,1299,-1532503,1256207,-2,130,0
-1409,608,801,0,7032,9251,0,124,1
-839182,-157306,1002987,6499,-241732,1520143,837,130,0
-43,-94,138,1,-10929,15977,1,124,1
-109855,966586,-856733,-2,1492492,-1321564,1255,130,0
239675,-136173,-103501,1,-176224,-133943,0,124,1
-1320,-4103,5423,0,-11848,15661,0,124,1
795629,-1026389,232058,1298,-1557849,352542,-2,130,0
-565522,1084890,-520020,-652,1633468,-782800,1046,130,0
547970,-1086841,542120,3249,-1633887,813172,-630,130,0
0,0,0,0,0,0,0,124,1
-976337,876232,103353,3248,1332246,153334,1256,130,0
-189808,-163807,355563,1948,-751379,1631582,-2,130,0
30000,30000,30000,90000,60000,60000,180000,124,1
-978287,627923,349713,-651,1037308,574793,1046,130,0
911984,-791080,-120255,649,-1305644,-197324,-421,130,0
284060,-327613,45501,1948,-1504224,200046,-211,130,0
205407,-354264,151455,2598,-1627603,689793,-420,130,0
0,0,0,0,0,0,0,124,1
840481,-876233,37051,1299,-1444734,61375,-630,130,0
354263,-159906,-193708,649,-730013,-900733,-630,130,0
-531720,-137806,672125,2599,-320075,1547165,627,130,0
367263,-557721,191107,649,-1607913,553007,-421,130,0
-725428,-336063,1064739,3248,-507972,1598276,-2,130,0
-1083591,585021,502468,3898,879366,753054,1465,130,0
0,0,0,0,0,0,0,124,1
0,0,0,0,0,0,0,124,1
5226,-738,-4487,1,-2132,-12958,0,124,1
230108,-1033539,806680,3249,-1554707,1211799,-211,130,0
-551221,165106,387414,1299,475502,1115442,417,130,0
-482,-14,497,1,-427,14354,0,124,1
-23401,929534,-904834,1299,1433002,-1395508,1464,130,0
298361,-1043290,750128,5199,-1584452,1137227,-420,130,0
-1062790,332162,732577,1949,498335,1098265,1046,130,0
-603873,-451117,1059539,4549,-698173,1628021,417,130,0
170000,62224,-232224,0,80525,-300525,0,124,1
355563,-183307,-170307,1949,-841033,-792226,-420,130,0
883383,-59803,-826181,-2601,-99291,-1361992,-2,130,0
-4301,5332,-1030,1,15397,-2976,1,124,1
-840482,871682,-32502,-1302,1441800,-54882,1046,130,0
-598023,-28602,627923,1298,-66822,1446618,418,130,0
92003,146356,-238359,0,189402,-308465,0,124,1
0,0,0,0,0,0,0,124,1
1086840,-548621,-538871,-652,-824694,-808775,-211,130,0
-828782,-193708,1026388,3898,-292843,1537948,418,130,0
1067339,-639624,-427066,649,-973001,-649785,-211,130,0
142355,-81254,-59153,1948,-925660,-702781,-420,130,0
335412,-269111,-65003,1298,-1235051,-308554,-420,130,0
182813,-226626,43812,-1,-293281,56698,-1,124,1
48751,-952286,908734,5199,-1448714,1378539,207,130,0
397814,-548621,150805,-2,-1581310,435493,-211,130,0
944485,-936686,-6501,1298,-1409333,-11312,-421,130,0
-141313,-97786,239099,0,-126546,309422,1,124,1
-1066040,358163,711126,3249,536459,1067891,836,130,0
1043939,-780680,-261310,1949,-1177028,-392552,-211,130,0
85153,-142356,59802,2599,-1625299,668846,-420,130,0
-689676,479717,211907,1948,1108948,484510,837,130,0
205,-650,444,-1,-1231,842,-1,124,1
-589573,-479718,1075140,5849,-730851,1630744,417,130,0
748828,-937986,188507,-651,-1545071,312742,-421,130,0
-9751,-851532,863232,1949,-1406400,1422947,-211,130,0
-1066040,421215,648724,3899,638053,983683,1255,130,0
523269,-77353,-447867,-1951,-221204,-1290562,-2,130,0
899633,-976987,79302,1948,-1470708,118771,-420,130,0
437,946,-1383,0,10929,-15977,-1,124,1
-938636,-3901,945785,3248,-8170,1418549,418,130,0
22,-132,109,-1,-15249,12694,0,124,1
1073190,-572022,-501169,-1,-869731,-762481,-211,130,0
-5639,3204,2435,0,9251,7032,0,124,1
-275611,701376,-421866,3899,1622156,-980333,836,130,0
127404,-9101,-117005,1298,-87770,-1368067,417,130,0
1076440,-410816,-664325,1299,-618992,-999395,-211,130,0
141705,-90354,-49402,1949,-1030397,-582754,-631,130,0
511569,-991288,480367,648,-1633678,793692,-420,130,0
-147556,919784,-773529,-1301,1521190,-1276318,626,130,0
-114,129,-14,1,14922,-1707,1,124,1
-205,-444,650,1,-842,1231,1,124,1
222308,-946436,725427,1299,-1560991,1197555,-211,130,0
122204,2600,-122205,2599,38542,-1433213,-2,130,0
-4301,5332,-1030,1,15397,-2976,1,124,1
139755,-42252,-95554,1949,-471524,-1118585,-421,130,0
-140406,61102,80603,1299,710531,918537,836,130,0
-4000,-1464,5464,0,-4227,15777,0,124,1
977636,-79303,-897034,1299,-121495,-1349214,417,130,0
-330213,1060839,-729328,1298,1596600,-1098056,627,130,0
-88,528,-439,1,15249,-12694,0,124,1
712426,-1039389,328912,1949,-1598487,505457,-840,130,0
30000,30000,30000,90000,60000,60000,180000,124,1
-297712,-751429,1054339,5198,-1135342,1584870,-1,130,0
216,-560,344,0,-16194,9943,-1,124,1
235308,110504,-344513,1299,515093,-1599534,418,130,0
-40302,507018,-467368,-652,1470498,-1351309,836,130,0
-244410,341912,-96204,1298,1585708,-450995,1256,130,0
249609,-1041990,793679,1298,-1563924,1191061,-421,130,0
174206,841131,-1015989,-652,1265633,-1527056,1046,130,0
-788480,-220359,1011437,2598,-340603,1553658,208,130,0
-92304,-436817,529769,648,-1262911,1528731,-1,130,0
424465,-703977,281460,1948,-1622995,646851,-840,130,0
-1344,294,1050,0,3396,12138,0,124,1
42901,-510270,468017,648,-1471756,1350051,-630,130,0
0,0,0,0,0,0,0,124,1
61102,-967887,910684,3899,-1457511,1367647,-210,130,0
0,0,0,0,0,0,0,124,1
529769,-1084891,559020,3898,-1633678,840194,-2,130,0
-673426,-395865,1075140,5849,-599930,1615872,418,130,0
-563,243,320,0,7032,9251,0,124,1
1260,-1186,-74,0,-13698,-854,1,124,1
0,0,0,0,0,0,0,124,1
-520670,-550571,1077090,5849,-840195,1633468,418,130,0
0,0,0,0,0,0,0,124,1
-1056290,435516,622723,1949,668846,956242,627,130,0
-128055,540170,-412116,-1,1563713,-1191272,836,130,0
-323063,284710,41601,3248,1316116,180984,1465,130,0
-988688,826830,164456,2598,1273803,249272,1046,130,0
1036138,-768329,-265860,1949,-1167811,-405121,207,130,0
64,77,-141,0,8896,-16311,0,124,1
-1065390,356863,712426,3899,534993,1069358,1047,130,0
66302,74752,-139106,1948,883555,-1630955,836,130,0
-989338,436816,553820,1298,719329,910996,1046,130,0
55902,-141706,87753,1949,-1619643,995833,-629,130,0
-359464,-706577,1069290,3249,-1065169,1604979,-421,130,0
-352964,157305,196307,648,729174,901360,627,130,0
27059,-70105,43045,-1,-112169,68873,-1,124,1
677325,-520020,-156006,1299,-1199860,-360503,-630,130,0
-673426,-395865,1075140,5849,-599930,1615872,627,130,0
-6999,9562,-2562,1,27320,-7320,1,124,1
26650,-931485,906783,1948,-1434469,1394459,-211,130,0
-208658,-480368,690975,1949,-1110625,1592411,-630,130,0
403665,141055,-545371,-651,410147,-1573769,627,130,0
2955,-5654,2699,0,-16328,7793,-1,124,1
989337,-826831,-161857,649,-1274013,-248435,-210,130,0
-139,88,50,-1,10279,5853,-1,124,1
258709,304861,-564872,-1302,883974,-1631164,418,130,0
9777,-3547,-6229,1,-10136,-17799,1,124,1
65652,75402,-138456,2598,888164,-1630745,837,130,0
167706,-1013388,848931,3249,-1523495,1272337,-1,130,0
-656,418,238,0,792,451,0,124,1
-443,-4661,5105,1,-13461,14742,0,124,1
334762,226208,-562272,-1302,656277,-1622995,626,130,0
-326963,705276,-375065,3248,1632839,-871407,1255,130,0
83,57,-140,0,6643,-16244,-1,124,1
40951,-956836,920434,4549,-1443058,1384823,207,130,0
0,0,0,0,0,0,0,124,1
371813,-1067991,700726,4548,-1608332,1053857,-420,130,0
625973,-31202,-596723,-1952,-69336,-1378121,418,130,0
-842432,-155356,1001687,3899,-238380,1518886,837,130,0
457617,623373,-1079041,1949,938856,-1626556,1046,130,0
0,0,0,0,0,0,0,124,1
-273011,-58503,332812,1298,-270849,1530197,417,130,0
-336063,-226209,563571,1299,-654393,1622994,-1,130,0
-666275,1060189,-391965,1949,1616081,-599511,1255,130,0
-806031,-94904,902883,1948,-157733,1486837,418,130,0
143005,209307,-348414,3898,972372,-1622576,418,130,0
-85804,-895084,982836,1948,-1345444,1475316,-2,130,0
-566,-17,584,1,-32,1106,1,124,1
1045239,-270411,-772879,1949,-409729,-1164040,418,130,0
-375065,1056939,-681226,648,1611682,-1037938,1255,130,0
-271711,-59153,332812,1948,-271477,1530407,418,130,0
314611,-301612,-11051,1948,-1385034,-58024,-630,130,0
121554,861282,-984137,-1301,1312974,-1497730,1255,130,0
-33,-102,135,0,-11848,15661,0,124,1
803430,96203,-901584,-1951,157732,-1486209,836,130,0
-263910,334112,-68253,1949,1549050,-324055,1465,130,0
-223609,691625,-466068,1948,1601628,-1080042,836,130,0
354913,-1042640,691625,3898,-1606028,1062654,-631,130,0
673425,-1065390,395214,3249,-1615873,598463,-211,130,0
-479718,497268,-16901,649,1439496,-50693,836,130,0
30000,30000,30000,90000,60000,60000,180000,124,1
215808,-561622,346462,648,-1618596,999603,-211,130,0
1058239,-750779,-304862,2598,-1128430,-459165,-630,130,0
-72803,-67603,143655,3249,-776516,1632630,-1,130,0
566821,81253,-647425,649,188734,-1498987,417,130,0
-88,-439,528,1,-12694,15249,0,124,1
122204,2600,-122855,1949,38542,-1433213,207,130,0
-5201,-302912,310061,1948,-1400535,1428603,-211,130,0
-4301,-1030,5332,1,-2976,15397,1,124,1
290560,29901,-319162,1299,143907,-1480763,208,130,0
-125617,240333,-114716,0,311020,-148456,1,124,1
675375,397814,-1071891,1298,596787,-1614825,418,130,0
558370,-359464,-199558,-652,-1036890,-575003,-839,130,0
492718,-1086841,596072,1949,-1631374,894238,-421,130,0
-228649,178664,49985,0,231212,64686,-1,124,1
-504,29,474,-1,854,13698,-1,124,1
0,0,0,0,0,0,0,124,1
43,-138,94,-1,-15977,10929,-1,124,1
0,0,0,0,0,0,0,124,1
740377,317861,-1056290,1948,475921,-1590527,626,130,0
-337363,-724128,1066039,4548,-1090515,1598486,-210,130,0
0,0,0,0,0,0,0,124,1
-971787,116354,858032,2599,176166,1318421,1046,130,0
-100,-36,136,0,-4227,15777,0,124,1
-391965,1071240,-678626,649,1615034,-1022227,1256,130,0
-177457,351663,-172257,1949,1633886,-804585,1045,130,0
-889884,-73453,969186,5849,-113535,1467984,417,130,0
607772,-618824,12350,1298,-1427557,25765,-839,130,0
382214,687075,-1069291,-2,1036051,-1611264,627,130,0
-848932,-16901,868432,2599,-30793,1429860,627,130,0
-204988,211281,-6293,0,273423,-8144,0,124,1
137,-97,-40,0,-11243,-4639,0,124,1
30000,30000,30000,90000,60000,60000,180000,124,1
-111155,967886,-856733,-2,1492702,-1321145,1046,130,0
-687076,1069940,-381565,1299,1612311,-576679,1046,130,0
831,-1406,575,0,-16244,6643,-1,124,1
222115,-31380,-190735,0,-40610,-246833,0,124,1
36946,33740,-70686,0,53984,-113098,-1,124,1
-103,-516,620,1,-978,1175,1,124,1
30000,30000,30000,90000,60000,60000,180000,124,1
-825531,1023788,-197608,649,1540881,-299337,1256,130,0
-627924,31201,599322,2599,69125,1378539,207,130,0
566171,81903,-648075,-1,190410,-1499406,836,130,0
45501,-139756,96853,2598,-1596601,1098265,-839,130,0
30000,30000,30000,90000,60000,60000,180000,124,1
566,17,-584,-1,32,-1106,-1,124,1
23400,-132605,111154,1949,-1524752,1270242,-211,130,0
-5818,-4026,9845,1,-11504,28129,0,124,1
1037438,-710477,-327613,-652,-1093448,-504620,-630,130,0
-1075141,689025,388064,1948,1034166,578354,837,130,0
-1082941,510919,575921,3899,768555,864493,1255,130,0
-973737,94903,883383,4549,142441,1338530,1255,130,0
92953,436166,-528470,649,1262282,-1528942,627,130,0
-4576,-591,5167,0,-1707,14922,1,124,1
841781,-875583,35751,1949,-1443058,58023,-840,130,0
-765729,1049139,-282111,1299,1579424,-427325,1046,130,0
-21850,-47314,69165,1,-75703,110664,0,124,1
-1066040,418615,650674,3249,635959,985359,1046,130,0
-70710,35355,35355,0,56568,56568,-1,124,1
-204988,211281,-6293,0,273423,-8144,0,124,1
-1082941,582421,504418,3898,876224,756405,1465,130,0
-591523,-477768,1075140,5849,-728128,1630535,836,130,0
-93604,-436167,530419,648,-1260817,1529988,-2,130,0
222308,-947086,726077,1299,-1561619,1196298,-630,130,0
-91,-47,139,1,-5452,16060,0,124,1
-731278,1057589,-325663,648,1595343,-492261,1046,130,0
524569,463467,-989338,-1302,765832,-1632002,627,130,0
-1065390,358163,711776,4549,535831,1068729,1046,130,0
0,0,0,0,0,0,0,124,1
-488169,1083590,-594773,648,1631582,-894868,1255,130,0
22,109,-132,-1,12694,-15249,0,124,1
-9868,5607,4261,0,16020,12176,-1,124,1
-825531,1023138,-197608,-1,1540671,-299337,836,130,0
157955,517419,-673426,1948,1198812,-1560153,1046,130,0
67249,-52548,-14701,0,-84077,-23522,0,124,1
313311,391314,-704627,-2,905550,-1629698,418,130,0
-1002338,198907,806030,2599,304154,1238193,1256,130,0
-724128,-321763,1051739,5848,-491842,1594925,209,130,0
0,0,0,0,0,0,0,124,1
-64,141,-77,0,16311,-8896,0,124,1
1375,-973,-401,1,-11243,-4639,0,124,1
639623,-1082941,445916,2598,-1625509,668846,-211,130,0
-1052390,647424,408215,3249,994785,625275,1255,130,0
4494,-9885,5391,0,-28245,15404,-1,124,1
30000,30000,30000,90000,60000,60000,180000,124,1
650024,-85804,-564872,-652,-196067,-1306063,-211,130,0
-254,658,-404,0,1247,-766,0,124,1
-335413,-227509,563571,649,-657535,1623622,208,130,0
607122,474517,-1080991,648,713882,-1628860,627,130,0
-113105,-14951,131304,3248,-168626,1491026,627,130,0
567471,-1088791,523919,2599,-1633469,785103,-212,130,0
-7000,-2562,9562,0,-7320,27320,0,124,1
522,-73,-448,1,-2132,-12958,0,124,1
-558,202,355,-1,5853,10279,-1,124,1
-364014,555120,-190458,648,1608331,-553637,1046,130,0
557720,-359464,-198908,-652,-1038566,-572908,-630,130,0
226858,-349714,125454,2598,-1611264,571232,-839,130,0
-87754,-252860,342562,1948,-1162783,1574815,-630,130,0
54,86,-140,0,9943,-16194,-1,124,1
182813,-226626,43812,-1,-293281,56698,-1,124,1
65652,-143006,78002,648,-1631374,892982,-420,130,0
354913,-183957,-170307,649,-842919,-790341,-421,130,0
-350364,131954,219708,1298,612917,1004840,837,130,0
136505,-29902,-104004,2599,-341441,-1212428,-211,130,0
529769,529769,-1059540,-2,814639,-1632840,627,130,0
-634424,1079690,-445917,-651,1625717,-671779,1256,130,0
-5587,3559,2027,-1,10279,5853,-1,124,1
-110,-1165,1276,1,-13461,14742,0,124,1
-125617,-114716,240333,0,-148456,311020,1,124,1
979586,-876233,-101404,1949,-1330571,-155429,-1,130,0
-510920,987386,-478418,-1952,1633677,-790131,837,130,0
47451,585671,-632474,648,1359058,-1464215,1045,130,0
672125,-1065390,397164,3899,-1616292,600767,-421,130,0
-993888,877532,117654,1298,1320515,173443,1674,130,0
703976,-297712,-405616,648,-687071,-939486,-2,130,0
-156137,-80252,236390,1,-103856,305917,1,124,1
127404,-120255,-5851,1298,-1373932,-78553,-630,130,0
399,-546,146,-1,-15777,4227,-1,124,1
-254160,562921,-308762,-1,1630954,-894868,836,130,0
772878,277560,-1048490,1948,414127,-1575026,627,130,0
300311,729977,-1030289,-1,1124449,-1588013,627,130,0
1060839,-579822,-477118,3899,-894658,-736088,-211,130,0
-528470,1072540,-543421,649,1633886,-827208,1255,130,0
0,0,0,0,0,0,0,124,1
848281,17550,-865183,648,27021,-1427557,-2,130,0
369863,185256,-555771,-652,537925,-1604352,-2,130,0
-8820,8302,518,0,23721,1480,0,124,1
-1344,1050,294,0,12138,3396,0,124,1
-340613,247009,95553,1949,1148329,432351,836,130,0
-221,1320,-1099,0,15249,-12694,0,124,1
901583,-975037,76052,2598,-1468195,113115,-421,130,0
0,0,0,0,0,0,0,124,1
-1306,184,1121,-1,2132,12958,0,124,1
-211908,-140406,352963,649,-640777,1621318,-211,130,0
4576,591,-5167,0,1707,-14922,-1,124,1
429666,-535621,106603,648,-1542557,305411,-210,130,0
-68756,48674,20082,0,77878,32132,-1,124,1
130654,-351014,222308,1948,-1615663,1017827,-630,130,0
92303,436166,-528470,-1,1264586,-1527685,1255,130,0
0,-8573,8573,0,-24494,24494,0,124,1
9750,-616874,609072,1948,-1424624,1404304,-421,130,0
559020,-206708,-353614,-1302,-592180,-1021808,-1,130,0
444616,624023,-1067991,648,949330,-1625299,1046,130,0
-226209,691625,-463468,1948,1603094,-1074805,1046,130,0
30000,30000,30000,90000,60000,60000,180000,124,1
-671476,139755,532369,648,322587,1225415,627,130,0
318511,-24701,-291861,1949,-111440,-1355289,-211,130,0
-376365,-689026,1071240,5849,-1041080,1610635,-211,130,0
551220,-165757,-388065,-2602,-473618,-1116909,-420,130,0
-299012,-267161,566171,-2,-770232,1632420,-2,130,0
481668,-500519,18850,-1,-1440963,53834,-420,130,0
-177457,352313,-173557,1299,1633886,-806889,1046,130,0
586321,397164,-982837,648,654183,-1622576,1046,130,0
132604,-989338,861282,4548,-1502967,1306271,-2,130,0
549270,-393915,-156006,-651,-1134714,-450786,-840,130,0
1950,120254,-120905,1299,1411426,-1417712,1045,130,0
-288611,-31852,322412,1949,-144118,1480971,626,130,0
-6429,-3304,9733,0,-9441,27810,0,124,1
920434,-919135,650,1949,-1414779,-210,-420,130,0
720877,341912,-1062790,-1,513417,-1599324,208,130,0
458267,-1072541,617523,3249,-1627813,936552,-211,130,0
141,-70,-70,1,-8167,-8167,0,124,1
325012,-286661,-37702,649,-1315489,-181404,-630,130,0
-1066690,418615,650024,1949,636587,984940,1255,130,0
-896384,975036,-76053,2599,1470288,-117724,1465,130,0
208657,-1025089,820330,3898,-1544233,1234003,208,130,0
-82554,-57853,141705,1298,-660677,1623622,-211,130,0
-665625,1060839,-392615,2599,1616081,-599721,1255,130,0
0,0,0,0,0,0,0,124,1
-1054340,345162,713076,3898,522215,1079412,836,130,0
-572022,-514170,1088790,2598,-774840,1632630,-1,130,0
-177457,-376365,555120,1298,-1085697,1599742,-630,130,0
67602,-889234,820980,-652,-1467776,1354869,-630,130,0
-2310,9491,-7180,1,27119,-20516,1,124,1
-976337,875582,104653,3898,1331198,155009,1255,130,0
-328263,560971,-232709,-1,1625926,-674293,836,130,0
-351664,204757,148205,1298,949749,676806,1256,130,0
-73453,-67603,143655,2599,-777144,1632630,-1,130,0
-789780,-217759,1010137,2598,-337252,1552821,627,130,0
976986,-629224,-347764,-2,-1038985,-572280,-421,130,0
432266,99453,-531720,-1,288862,-1536483,-2,130,0
-372464,978286,-607773,-1951,1618385,-1003165,836,130,0
-891834,-88404,984136,3898,-134691,1477201,837,130,0
165106,761828,-928235,-1301,1258092,-1531036,836,130,0
642,770,-1412,0,8896,-16311,0,124,1
0,575,-575,0,1090,-1090,0,124,1
30000,30000,30000,90000,60000,60000,180000,124,1
-822281,990637,-166407,1949,1527055,-259537,1465,130,0
706576,-393265,-312662,649,-906389,-723310,-211,130,0
675375,397164,-1071241,1298,595530,-1614406,418,130,0
640273,-1082941,445266,2598,-1625299,668427,-1,130,0
-21451,-927585,953585,4549,-1396764,1431955,-420,130,0
646,-188,-457,1,-357,-866,0,124,1
0,0,0,0,0,0,0,124,1
120,-124,3,-1,-14354,427,0,124,1
24050,-132605,111154,2599,-1523914,1271499,209,130,0
503768,-476468,-25351,1949,-1375398,-75830,-630,130,0
30000,30000,30000,90000,60000,60000,180000,124,1
318511,-25351,-292511,649,-113535,-1354241,-420,130,0
537570,-423816,-114405,-651,-1221226,-328873,-211,130,0
-191108,-828782,1023138,3248,-1247829,1536901,-210,130,0
0,0,0,0,0,0,0,124,1
1067339,-417316,-647425,2598,-635750,-985151,-211,130,0
-169657,550570,-381565,-652,1595762,-1102036,836,130,0
-2568,5649,-3080,1,16311,-8896,0,124,1
401715,141705,-545371,-1951,412870,-1574816,417,130,0
76702,-337363,263909,3248,-1557220,1205934,-629,130,0
-365314,-689026,1060839,6499,-1050715,1608750,-1,130,0
36946,33740,-70686,0,53984,-113098,-1,124,1
-214212,12582,201630,0,16283,260933,0,124,1
-4494,-5391,9885,0,-15404,28245,1,124,1
566,-584,17,-1,-1106,32,-1,124,1
-141313,239099,-97786,0,309422,-126546,1,124,1
-176807,-376365,553820,648,-1087583,1599323,-421,130,0
373113,-981537,609072,648,-1617968,1004631,-420,130,0
1396,-506,-889,1,-5853,-10279,1,124,1
326312,-286011,-39002,1299,-1312975,-185593,-420,130,0
900283,-962687,65002,2598,-1460863,96985,-211,130,0
-924985,956185,-31202,-2,1438867,-48808,1255,130,0
30000,30000,30000,90000,60000,60000,180000,124,1
902883,-974387,74752,3248,-1467566,112277,-1,130,0
-443967,-622724,1071890,5199,-948702,1626136,208,130,0
545370,-664325,120904,1949,-1533131,277970,-211,130,0
-61103,-271711,334112,1298,-1250552,1535225,-1,130,0
54,86,-140,0,9943,-16194,-1,124,1
-657175,554470,104003,1298,1283229,234399,1255,130,0
-686426,193707,494668,1949,446805,1137227,837,130,0
-132,-410,542,0,-11848,15661,0,124,1
314611,-300962,-11051,2598,-1384824,-58443,-839,130,0
0,0,0,0,0,0,0,124,1
400,146,-546,0,4227,-15777,0,124,1
256,308,-564,0,8896,-16311,0,124,1
646,-188,-457,1,-357,-866,0,124,1
369863,183306,-555771,-2602,533945,-1603304,418,130,0
33,102,-135,0,11848,-15661,0,124,1
166406,-1012738,849581,3249,-1522239,1274850,-212,130,0
114,14,-129,-1,1707,-14922,-1,124,1
-9145,7853,1292,0,22439,3691,-1,124,1
-1075791,395214,683175,2598,591341,1023064,627,130,0
697476,-246360,-450467,649,-567253,-1042965,-840,130,0
-156137,-80252,236390,1,-103856,305917,1,124,1
-106604,132604,-24051,1949,1540462,-298290,1046,130,0
-67249,14701,52548,0,23522,84077,0,124,1
926934,26650,-952936,648,38333,-1433003,418,130,0
142355,209957,-348414,3898,972581,-1622366,418,130,0
-323713,283410,42251,1948,1312346,187268,1255,130,0
-300312,-750129,1054339,3898,-1133457,1585498,-211,130,0
-59803,-271711,334112,2598,-1252019,1534596,-212,130,0
538870,-122205,-418616,-1951,-347935,-1207611,207,130,0
-16507,67798,-51291,0,108478,-82066,1,124,1
218408,810580,-1028339,649,1221016,-1550098,1256,130,0
130654,-350364,222958,3248,-1615454,1018456,-211,130,0
-7000,-2562,9562,0,-7320,27320,0,124,1
648074,323062,-971137,-1,531851,-1602885,628,130,0
-663025,-397815,1066689,5849,-608519,1617338,417,130,0
-22101,-928235,952935,2599,-1396764,1432164,-211,130,0
999,-1366,366,-1,-15777,4227,-1,124,1
143005,-62403,-77353,3249,-709275,-919586,-421,130,0
30000,30000,30000,90000,60000,60000,180000,124,1
135855,406265,-543421,-1301,1179121,-1568532,627,130,0
22,109,-132,-1,12694,-15249,0,124,1
841781,159255,-997788,3248,239846,-1518468,837,130,0
-987387,570071,417315,-1,940741,686860,1255,130,0
-341263,246359,96853,1949,1145396,436541,1256,130,0
-139106,50701,90353,1948,590712,1023693,836,130,0
48751,462167,-511570,-652,1340206,-1478668,627,130,0
-990638,502468,488818,648,829092,805003,1255,130,0
172256,842431,-1015339,-652,1266890,-1526428,627,130,0
126104,-994538,872332,3898,-1498987,1311927,-1,130,0
0,0,0,0,0,0,0,124,1
0,0,0,0,0,0,0,124,1
-942536,936035,9750,3249,1409332,11730,1256,130,0
-33,-102,135,0,-11848,15661,0,124,1
209957,479067,-688376,648,1109995,-1592202,1255,130,0
431616,-1055640,626623,2599,-1624461,962945,-421,130,0
-1086841,562921,524569,649,846060,787407,1046,130,0
1060839,-329563,-729978,1298,-496870,-1099313,-840,130,0
-2310,9491,-7180,1,27119,-20516,1,124,1
453066,-1080341,630523,3248,-1626346,948282,208,130,0
-114405,-232059,349713,3249,-1070825,1603513,-630,130,0
637673,-976987,339312,-2,-1609379,560129,-630,130,0
100,36,-136,0,4227,-15777,0,124,1
0,0,0,0,0,0,0,124,1
-633774,1080990,-445917,1299,1625717,-671779,1256,130,0
34451,101403,-133906,1948,1181425,-1567275,1255,130,0
450466,244409,-696177,-1302,565785,-1609379,417,130,0
-50000,-18301,68301,0,-29282,109282,0,124,1
114,-129,14,-1,-14922,1707,-1,124,1
904183,68902,-970487,2598,102013,-1462120,837,130,0
437466,642224,-1078391,1299,965669,-1623204,628,130,0
-358814,-707227,1069940,3899,-1065588,1604979,-421,130,0
39001,908734,-947736,-1,1385033,-1442429,1256,130,0
1548,7693,-9241,0,21981,-26405,0,124,1
85803,809280,-897034,-1951,1338320,-1480344,836,130,0
0,0,0,0,0,0,0,124,1
34451,101403,-134556,1298,1180797,-1567485,1045,130,0
74752,-142356,69552,1948,-1633469,785313,-630,130,0
5639,-3204,-2435,0,-9251,-7032,0,124,1
0,0,0,0,0,0,0,124,1
650024,321762,-971137,649,529128,-1602257,837,130,0
94253,46801,-137806,3248,541486,-1604980,208,130,0
1073840,-496619,-576572,649,-755359,-876644,-211,130,0
984786,-100754,-883384,648,-154591,-1330780,-1,130,0
-1074491,687725,388064,1298,1033328,579401,836,130,0
3059,6624,-9683,0,18925,-27666,-1,124,1
4494,5391,-9885,0,15404,-28245,-1,124,1
956835,-926285,-29902,648,-1391528,-45666,-631,130,0
800179,234658,-1033539,1298,351076,-1556383,1046,130,0
336062,-268461,-65653,1948,-1234633,-309182,-630,130,0
559670,-208008,-352964,-1302,-596369,-1018666,-420,130,0
-442017,986086,-544721,-652,1630954,-899476,627,130,0
-179407,-375065,554470,-2,-1082555,1600580,208,130,0
823580,-992588,171606,2598,-1527685,261840,-421,130,0
-216,560,-344,0,16194,-9943,1,124,1
-146256,1003637,-857383,-2,1512183,-1291190,1046,130,0
-3999,5464,-1464,1,15777,-4227,1,124,1
-786530,-256110,1044589,1949,-386268,1567903,837,130,0
120,3,-124,-1,427,-14354,0,124,1
1083590,-508970,-573972,648,-769184,-863656,-420,130,0
4823,148,-4971,0,427,-14354,0,124,1
-56124,-174391,230515,0,-225683,298314,0,124,1
-172257,678625,-505069,1299,1572511,-1169696,1046,130,0
563,-320,-243,0,-9251,-7032,0,124,1
674725,400415,-1071891,3249,599929,-1615244,627,130,0
646,-188,-457,1,-357,-866,0,124,1
-451767,-243760,698776,3249,-565158,1609378,-211,130,0
156137,80252,-236390,-1,103856,-305917,-1,124,1
5547,58274,-63822,-1,93239,-102115,0,124,1
-1084241,509619,577221,2599,767088,865750,1255,130,0
217758,811230,-1028339,649,1221435,-1549889,837,130,0
-527820,1071890,-543421,649,1633886,-827837,1464,130,0
235308,111154,-344513,1949,518654,-1600372,-2,130,0
-1015989,836581,181356,1948,1261025,269381,1255,130,0
579171,-644175,66952,1948,-1484743,151867,-421,130,0
0,0,0,0,0,0,0,124,1
-222115,31380,190735,0,40610,246833,0,124,1
-304212,-726728,1033538,2598,-1122355,1588850,-420,130,0
-374415,1056939,-683176,-652,1611473,-1039823,1255,130,0
362713,343212,-705927,-2,796205,-1632840,627,130,0
306161,1950,-306162,1949,15919,-1422320,-2,130,0
-5379,1176,4203,0,3396,12138,0,124,1
-335413,-227509,562921,-1,-657326,1623413,-2,130,0
75402,-143006,69552,1948,-1633469,781333,-840,130,0
-980887,890533,93603,3249,1341044,138042,1465,130,0
-224259,690975,-465418,1298,1601628,-1079204,627,130,0
30000,30000,30000,90000,60000,60000,180000,124,1
-108555,-879483,991287,3249,-1325544,1489560,-421,130,0
55252,85153,-138456,1949,992272,-1619434,418,130,0
-34452,-911335,950335,4548,-1386291,1441800,208,130,0
-5851,-302262,311361,3248,-1399488,1429441,-2,130,0
-352964,1041989,-687076,1949,1606446,-1061189,1046,130,0
-504,29,474,-1,854,13698,-1,124,1
-919135,141055,779379,1299,231048,1284905,627,130,0
-937336,-2601,945135,5198,-6494,1417920,627,130,0
1074490,-570722,-501819,1949,-868684,-763528,-1,130,0
-174,-378,553,1,-10929,15977,1,124,1
7527,1804,-9331,0,5154,-26661,0,124,1
139755,-98804,-39002,1949,-1128639,-458955,-839,130,0
34451,101403,-134556,1298,1183939,-1566228,1046,130,0
-824881,1023788,-197608,1299,1540881,-299127,1256,130,0
54,86,-140,0,9943,-16194,-1,124,1
1051089,-646775,-403016,1298,-997090,-621925,-420,130,0
0,0,0,0,0,0,0,124,1
-664,332,332,0,629,629,0,124,1
132604,-989338,859982,3248,-1503386,1305852,-211,130,0
143005,-72803,-68253,1949,-821971,-811498,-420,130,0
0,-939936,943835,3899,-1413732,1415616,-421,130,0
672775,-1066040,395864,2599,-1616082,599720,-420,130,0
-766379,1049789,-280161,3249,1578586,-424392,1256,130,0
29251,-931485,905483,3249,-1435517,1392993,-420,130,0
30000,30000,30000,90000,60000,60000,180000,124,1
1950,120904,-120905,1949,1413940,-1415198,1255,130,0
30000,30000,30000,90000,60000,60000,180000,124,1
330862,-563572,234008,1298,-1626137,674920,-630,130,0
-340613,247009,96203,2599,1147700,433398,1254,130,0
-44,510,-466,0,14742,-13461,0,124,1
141,-70,-70,1,-8167,-8167,0,124,1
214508,135205,-349064,649,634911,-1620272,836,130,0
-795630,906783,-111155,-2,1498777,-185593,1047,130,0
-349714,131304,220358,1948,609774,1007354,627,130,0
30000,30000,30000,90000,60000,60000,180000,124,1
1085540,-547971,-538871,-1302,-823857,-809403,-421,130,0
-75403,336062,-258710,1949,1559314,-1201955,836,130,0
-166407,1012087,-845682,-2,1523494,-1272338,836,130,0
30000,30000,30000,90000,60000,60000,180000,124,1
-632,138,493,-1,261,935,-1,124,1
-705277,296411,410165,1299,684137,942836,836,130,0
729327,300961,-1030289,-1,462096,-1587385,207,130,0
30000,30000,30000,90000,60000,60000,180000,124,1
30000,30000,30000,90000,60000,60000,180000,124,1
-205408,-807981,1019238,5849,-1230653,1545908,-2,130,0
-362064,-344513,708526,1949,-798091,1633049,209,130,0
-509620,987386,-479718,-1952,1633677,-791807,837,130,0
30000,30000,30000,90000,60000,60000,180000,124,1
33801,101403,-134556,648,1183730,-1566228,1046,130,0
355563,-184607,-169007,1949,-844385,-788665,-211,130,0
-451767,-243110,698776,3899,-564529,1609588,209,130,0
50701,-328913,280810,2598,-1514069,1288257,-210,130,0
399,146,-546,-1,4227,-15777,-1,124,1
785229,260009,-1041340,3898,387733,-1567485,626,130,0
-106604,131954,-24701,649,1541300,-300594,1256,130,0
281460,-703327,423815,1948,-1622576,976561,-630,130,0
3325,-5625,2300,0,-16244,6643,-1,124,1
988037,-501819,-489469,-3251,-828046,-805214,-421,130,0
-987387,569421,418615,649,939066,688536,837,130,0
469317,-694227,228158,3248,-1602048,523262,-631,130,0
0,-208206,208206,0,-269443,269443,0,124,1
358163,708526,-1066040,649,1064749,-1604980,627,130,0
70710,-35355,-35355,0,-56568,-56568,1,124,1
85153,-142356,59152,1949,-1625090,664237,-840,130,0
-5500,1606,3893,-1,4639,11243,0,124,1
632,-138,-493,1,-261,-935,1,124,1
1073840,-393265,-679926,649,-592808,-1021808,-420,130,0
961386,-687076,-274311,-1,-1133876,-451624,-630,130,0
890533,53952,-943186,1299,81694,-1453113,627,130,0
172906,-680576,509619,1949,-1571046,1173047,-630,130,0
141705,-91004,-48752,1949,-1033958,-578145,-421,130,0
-379615,-687726,1071890,4549,-1039194,1611054,-210,130,0
0,0,0,0,0,0,0,124,1
90353,249609,-339963,-1,1163830,-1574188,836,130,0
-130005,17550,114404,1949,216594,1293703,627,130,0
-146906,1004287,-856083,1298,1513230,-1289514,1046,130,0
453066,-1080341,630523,3248,-1626346,948492,-1,130,0
119604,-663675,546020,1949,-1531455,1258092,-630,130,0
710476,-1040039,330862,1299,-1598696,508809,-211,130,0
87103,893783,-980237,649,1345233,-1474898,836,130,0
-31852,133905,-102054,-1,1564551,-1189596,1255,130,0
-502469,476467,26650,648,1375816,76038,1465,130,0
-658475,-414716,1079690,6499,-627581,1619642,207,130,0
-138456,88403,52001,1948,1031234,581915,837,130,0
-1066690,640273,430966,4549,972791,650622,1465,130,0
-941236,739727,200857,-652,1222273,328243,1046,130,0
522,-73,-448,1,-2132,-12958,0,124,1
109204,-133906,27951,3249,-1542767,304992,-630,130,0
783929,261959,-1041990,3898,390247,-1568113,627,130,0
351663,-133255,-216459,1949,-610194,-1006936,-1,130,0
-1034189,811230,224258,1299,1218921,333271,1465,130,0
18862,198133,-216996,-1,256407,-280818,-1,124,1
428366,-536271,108554,649,-1544652,311695,-211,130,0
800830,233358,-1032239,1949,348981,-1555754,837,130,0
-134,29,105,0,3396,12138,0,124,1
887933,57202,-944486,649,85883,-1455207,417,130,0
209307,-1025089,819030,3248,-1544862,1232956,208,130,0
-166407,1012737,-845032,1298,1523913,-1271500,836,130,0
30000,30000,30000,90000,60000,60000,180000,124,1
-539521,121554,417965,-2,350238,1206772,837,130,0
-987387,108554,884033,5200,160456,1327847,1046,130,0
-45922,-23603,69526,1,-37765,111242,1,124,1
2164,3443,-5608,-1,9943,-16194,-1,124,1
2310,7180,-9491,-1,20516,-27119,-1,124,1
-760529,-167707,930184,1948,-279018,1533549,627,130,0
-993888,876232,119604,1948,1318421,176794,1255,130,0
-353614,182006,172256,648,844593,788874,1255,130,0
-890534,-52652,947085,3899,-83580,1454578,627,130,0
-3673,-1888,5562,1,-5452,16060,0,124,1
738,674,-1413,-1,7793,-16328,-1,124,1
141055,-52652,-87754,649,-591551,-1022856,-420,130,0
345812,-107905,-237259,648,-488491,-1105597,-420,130,0
355563,-183957,-169007,2599,-842709,-790550,-420,130,0
841781,-875583,34451,649,-1442429,56557,-630,130,0
598672,26000,-623374,1298,59909,-1443267,209,130,0
-64,-77,141,0,-8896,16311,0,124,1
281460,-703327,424465,2598,-1622576,977190,-420,130,0
-1068641,703976,366613,1948,1058256,549027,1255,130,0
940585,-923685,-14951,1949,-1402211,-24928,-212,130,0
-372464,1056289,-683826,-1,1610844,-1041289,1255,130,0
-344513,105303,240509,1299,491422,1103083,208,130,0
592172,481668,-1072541,1299,731059,-1630117,627,130,0
520669,554470,-1073191,1948,842918,-1632421,1256,130,0
-201508,351013,-148856,649,1627812,-692098,837,130,0
-878183,992587,-113105,1299,1493330,-172397,1045,130,0
0,0,0,0,0,0,0,124,1
705926,-394565,-312012,-651,-908693,-721215,-420,130,0
-4823,4971,-148,0,14354,-427,0,124,1
-63053,-77353,143655,3249,-886489,1631163,-211,130,0
132,410,-542,0,11848,-15661,0,124,1
-117655,660424,-544071,-1302,1531873,-1257256,836,130,0
8450,852181,-859983,648,1408703,-1420644,836,130,0
30000,30000,30000,90000,60000,60000,180000,124,1
-1066690,638973,432916,5199,970068,654183,1675,130,0
0,-4898,4898,0,-14145,14145,0,124,1
-504,29,474,-1,854,13698,-1,124,1
1037438,-713077,-323063,1298,-1098475,-498336,-1049,130,0
30000,30000,30000,90000,60000,60000,180000,124,1
988687,-501819,-489469,-2601,-828256,-805004,-421,130,0
0,0,0,0,0,0,0,124,1
460217,54602,-515470,-651,161922,-1488094,209,130,0
4301,-5332,1030,-1,-15397,2976,-1,124,1
1084890,-562272,-521970,648,-846689,-786361,-420,130,0
175506,-681226,507669,1949,-1572512,1170114,-630,130,0
235308,110504,-344513,1299,515931,-1599953,-211,130,0
30000,30000,30000,90000,60000,60000,180000,124,1
578521,-644175,67602,1948,-1485581,154171,-212,130,0
511569,573321,-1083591,1299,862189,-1632002,1046,130,0
-284711,-752079,1042639,5849,-1146026,1581309,-2,130,0
788479,221658,-1007538,2599,339555,-1552822,1046,130,0
12350,-128055,118304,2599,-1474269,1346071,-420,130,0
42251,-509620,468667,1298,-1470289,1351727,-210,130,0
748828,-937986,188507,-651,-1545071,312533,-420,130,0
826180,-991288,167056,1948,-1525590,255975,-630,130,0
-409516,1075790,-664325,1949,1618804,-1000652,1045,130,0
-295,-269,565,1,-7793,16328,1,124,1
30000,30000,30000,90000,60000,60000,180000,124,1
-673426,-395215,1075140,6499,-598883,1615662,208,130,0
-703327,1067990,-363364,1299,1607074,-548191,1045,130,0
-650675,85153,568771,3249,194600,1306900,418,130,0
614,-527,-86,1,-998,-164,0,124,1
-371164,978286,-609073,-1951,1618176,-1005050,627,130,0
60290,1850,-62141,-1,2961,-99426,0,124,1
-542771,662374,-117655,1948,1533130,-277133,1046,130,0
0,0,0,0,0,0,0,124,1
-5040,4744,296,0,13698,854,-1,124,1
514819,572021,-1084891,1949,859256,-1632212,626,130,0
102053,554470,-655225,1298,1284067,-1516164,1255,130,0
-141313,239099,-97786,0,309422,-126546,1,124,1
831,575,-1406,0,6643,-16244,-1,124,1
1043289,-781330,-260010,1949,-1177865,-391505,-420,130,0
-48102,326312,-276911,1299,1515115,-1286372,836,130,0
-945786,213858,732577,649,350866,1206562,1045,130,0
703976,-295762,-406916,1298,-683091,-943256,-211,130,0
1077090,-653275,-422516,1299,-984522,-636588,-211,130,0
-139106,88403,52001,1298,1032071,580867,836,130,0
0,122,-122,0,14145,-14145,0,124,1
-904184,-63703,973736,5849,-99500,1462119,1046,130,0
9750,-617524,609072,1298,-1425043,1403885,-630,130,0
1205,-1242,37,0,-14354,427,0,124,1
-1031589,264559,774179,7149,399045,1172628,1256,130,0
522,-73,-448,1,-2132,-12958,0,124,1
239675,-103501,-136173,1,-133943,-176224,0,124,1
-874283,956185,-79953,1949,1474687,-127569,1465,130,0
263259,435516,-698777,-2,1008610,-1616711,417,130,0
30000,30000,30000,90000,60000,60000,180000,124,1
-1059540,580471,481018,1949,892772,738810,1465,130,0
233773,-165491,-68281,1,-214165,-88364,1,124,1
91,47,-139,-1,5452,-16060,0,124,1
-286661,-749479,1043289,7149,-1143093,1582356,208,130,0
45501,92953,-136506,1948,1087791,-1598906,626,130,0
595422,477767,-1071891,1298,726032,-1629698,627,130,0
-48102,-911985,964636,4549,-1376236,1450388,-2,130,0
5200,485568,-492719,-1951,1407865,-1421273,626,130,0
30000,30000,30000,90000,60000,60000,180000,124,1
656,-238,-418,0,-451,-792,0,124,1
1004937,-144306,-859333,1298,-218062,-1292447,417,130,0
0,0,0,0,0,0,0,124,1
598672,25350,-623374,648,59699,-1443058,208,130,0
-1077091,433566,647424,3899,649784,973210,1046,130,0
-1748,-3785,5533,0,-10929,15977,1,124,1
-4823,-148,4971,0,-427,14354,0,124,1
-9751,615573,-605173,649,1426508,-1402211,1045,130,0
-110,1276,-1165,1,14742,-13461,0,124,1
3325,2300,-5625,0,6643,-16244,-1,124,1
-564222,323712,241159,649,934038,693983,1046,130,0
126,-7,-118,1,-854,-13698,1,124,1
30000,30000,30000,90000,60000,60000,180000,124,1
47451,913934,-960736,649,1377911,-1448504,1256,130,0
-41562,70323,-28760,1,112517,-46016,1,124,1
-211258,1015338,-804081,-1,1548003,-1226044,1046,130,0
221,-1320,1099,0,-15249,12694,0,124,1
575271,-987387,412115,-1,-1626556,681205,-211,130,0
30000,30000,30000,90000,60000,60000,180000,124,1
318511,-25351,-292511,649,-112068,-1354870,-1,130,0
-397815,545370,-148206,-651,1580052,-429629,836,130,0
356213,-183307,-170307,2599,-839358,-793693,-212,130,0
-550,160,389,-1,4639,11243,0,124,1
-315262,-653925,970486,1299,-1080880,1600999,-421,130,0
114,14,-129,-1,1707,-14922,-1,124,1
-400,-146,546,0,-4227,15777,0,124,1
-164457,-762479,928234,1298,-1259979,1530407,-2,130,0
-878183,833981,43551,-651,1378958,69963,1255,130,0
455017,532369,-988038,-652,878528,-1631583,418,130,0
-254,658,-404,0,1247,-766,0,124,1
-272361,-59153,333462,1948,-268335,1529150,208,130,0
466717,-694877,230108,1948,-1603095,528709,-420,130,0
-1076441,652624,427716,3899,981798,640358,1465,130,0
-872333,956835,-83204,1298,1475944,-130921,1046,130,0
263909,435516,-698127,1298,1009239,-1616711,208,130,0
38351,908734,-947086,-1,1385452,-1442220,836,130,0
-106604,-25351,135205,3250,-290330,1537110,626,130,0
-233773,68281,165491,-1,88364,214165,-1,124,1
537,-117,-420,0,-3396,-12138,0,124,1
-140406,78652,61752,-2,929849,698381,1046,130,0
-85804,-894434,983486,3248,-1345444,1475316,208,130,0
537,-607,69,-1,-1149,131,0,124,1
505,121,-626,0,229,-1186,0,124,1
-36402,-910035,951635,5198,-1384615,1443476,-1,130,0
-377015,1056939,-680576,-652,1611682,-1036681,1045,130,0
103,-620,516,-1,-1175,978,-1,124,1
41562,28760,-70323,-1,46016,-112517,-1,124,1
-989338,433566,555770,-2,715139,914557,836,130,0
-52652,138455,-84504,1299,1620061,-994367,1046,130,0
512869,571371,-1084241,-1,859256,-1632212,626,130,0
-570722,-514820,1088790,3248,-774840,1632839,417,130,0
204988,-211281,6293,0,-273423,8144,0,124,1
-41602,136505,-93604,1299,1596810,-1097637,1046,130,0
-918,-472,1390,0,-5452,16060,0,124,1
37609,-224447,186838,0,-290462,241791,-1,124,1
-10401,-851532,863232,1299,-1405562,1423366,-2,130,0
520019,552520,-1073191,-652,840823,-1632840,837,130,0
-371164,-184607,556420,649,-534784,1604141,208,130,0
0,0,0,0,0,0,0,124,1
-454368,517419,-61753,1298,1497101,-181613,1046,130,0
-525870,1071890,-545371,649,1633677,-830979,1464,130,0
-1004288,862582,142355,649,1298102,210520,1256,130,0
-20151,130654,-108555,1948,1523494,-1272128,627,130,0
132604,-989338,860632,3898,-1503595,1305643,-420,130,0
-666275,1072540,-404966,1299,1617967,-611870,1256,130,0
0,0,0,0,0,0,0,124,1
-178107,-375065,555120,1948,-1083603,1600371,-2,130,0
6429,3304,-9733,0,9441,-27810,0,124,1
120,3,-124,-1,427,-14354,0,124,1
-981537,889233,96203,3899,1339158,141603,1464,130,0
55902,-141706,87753,1949,-1619643,995623,-420,130,0
828131,-1027689,202157,2599,-1541719,302478,-211,130,0
-5818,9845,-4026,1,28129,-11504,0,124,1
505,-626,121,0,-1186,229,0,124,1
750778,-937336,187207,649,-1544233,310019,-630,130,0
973736,-91004,-880133,2599,-139509,-1339159,418,130,0
30000,30000,30000,90000,60000,60000,180000,124,1
-1051740,340612,716976,5848,515512,1084859,837,130,0
1073840,-688376,-382865,2599,-1035215,-577307,-630,130,0
-550,160,389,-1,4639,11243,0,124,1
505,121,-626,0,229,-1186,0,124,1
-1025739,822280,206707,3248,1236726,306668,1256,130,0
840481,-875583,37051,1949,-1444105,60328,-629,130,0
178756,373764,-554471,-1951,1084230,-1599743,418,130,0
-228649,49985,178664,0,64686,231212,-1,124,1
-85154,-895084,984136,3898,-1345653,1475316,208,130,0
45501,-139756,96853,2598,-1596811,1097427,-840,130,0
144955,-919785,776779,1949,-1518887,1280506,-211,130,0
2568,-5649,3080,-1,-16311,8896,0,124,1
-360114,-705927,1069940,3899,-1064331,1605398,-211,130,0
234658,111154,-344513,1299,520539,-1600581,418,130,0
-1320,-4103,5423,0,-11848,15661,0,124,1
-73,-67,141,1,-7793,16328,1,124,1
-606473,616223,-7801,1949,1426718,-23461,1256,130,0
107,25,-133,-1,2976,-15397,-1,124,1
-460868,-54603,515469,-2,-156896,1486627,417,130,0
30000,30000,30000,90000,60000,60000,180000,124,1
-675376,518719,157955,1298,1199859,360502,1046,130,0
458267,598022,-1056290,-1,921051,-1628232,836,130,0
-708527,346462,364013,1948,799138,834539,1046,130,0
-114,129,-14,1,14922,-1707,1,124,1
537,-420,-117,0,-12138,-3396,0,124,1
674075,-1065390,395214,3899,-1615873,597625,-211,130,0
-169007,1012737,-843732,-2,1524751,-1270243,836,130,0
-448517,1077740,-627274,1949,1626345,-947027,1254,130,0
459567,-1072541,616873,3899,-1627813,935295,208,130,0
696826,-960086,263909,649,-1581310,435703,-211,130,0
18862,-216996,198133,-1,-280818,256407,-1,124,1
3325,-5625,2300,0,-16244,6643,-1,124,1
541,-1402,860,-1,-16194,9943,-1,124,1
-822281,1025088,-202158,649,1542975,-306040,1255,130,0
1067990,-418616,-647425,1949,-636379,-984522,-211,130,0
0,0,0,0,0,0,0,124,1
-1014689,839831,177456,2598,1264167,264982,1464,130,0
-88,-439,528,1,-12694,15249,0,124,1
892483,89053,-980237,1299,131339,-1475317,417,130,0
-729978,1058239,-326963,1298,1595762,-493518,1255,130,0
299661,752078,-1051740,-1,1133666,-1585080,628,130,0
7527,-9331,1804,0,-26661,5154,0,124,1
174206,-680576,508319,1949,-1572093,1170952,-839,130,0
-258060,-783280,1045889,4549,-1179751,1568322,208,130,0
1006887,-174207,-829432,3248,-266240,-1262073,418,130,0
0,0,0,0,0,0,0,124,1
658474,-555771,-102054,649,-1281554,-236705,-630,130,0
55252,85153,-138456,1949,993319,-1619224,627,130,0
-576572,641574,-62403,2599,1483904,-149355,1255,130,0
-5172,-4723,9896,1,-13496,28274,0,124,1
202807,810580,-1013388,-1,1235260,-1542767,1465,130,0
-433567,-98804,532369,-2,-285931,1535853,836,130,0
-130,18,112,0,2132,12958,0,124,1
-729978,1058239,-326313,1948,1595972,-493937,1256,130,0
-9868,5607,4261,0,16020,12176,-1,124,1
-437,-946,1383,0,-10929,15977,1,124,1
213858,-561622,347763,-1,-1617968,1004421,-211,130,0
-632,493,138,-1,935,261,-1,124,1
456967,-1071891,618823,3899,-1627394,938647,-211,130,0
-311362,298361,13650,649,1386709,55091,1256,130,0
-1066690,640924,430316,4550,973210,650203,1465,130,0
-5547,63822,-58274,1,102115,-93239,0,124,1
221,1099,-1320,0,12694,-15249,0,124,1
-988688,827481,164456,3249,1273593,249900,1464,130,0
-934736,32501,904183,1948,48178,1389851,627,130,0
-440067,985436,-546671,-1302,1630744,-902618,836,130,0
-843082,-133906,981536,4548,-209264,1507574,626,130,0
195007,-1000388,807330,1949,-1540044,1241754,-420,130,0
705926,247009,-952936,-1,405329,-1572512,208,130,0
0,0,0,0,0,0,0,124,1
-397815,546020,-147556,649,1580052,-429001,1045,130,0
-311362,299011,14300,1949,1386499,55719,1464,130,0
40301,907433,-948386,-652,1383567,-1443686,1047,130,0
976336,-630524,-346463,-651,-1040242,-570814,-630,130,0
-465418,691625,-224909,1298,1602256,-522844,1465,130,0
-35752,-910685,950985,4548,-1385453,1442847,207,130,0
-390,-270,661,1,-511,1251,1,124,1
-525220,77352,447216,-652,222669,1290351,1046,130,0
-705927,-247010,955535,2598,-410148,1574396,208,130,0
-244410,341912,-96204,1298,1585708,-451624,1046,130,0
-228809,1031588,-802781,-2,1555334,-1210124,836,130,0
30000,30000,30000,90000,60000,60000,180000,124,1
115704,230758,-345163,1299,1074385,-1602257,627,130,0
694226,-960086,267160,1300,-1582986,441149,-421,130,0
300961,-967237,668225,1949,-1595344,1101826,-839,130,0
1073190,-571372,-501819,-1,-868684,-763319,208,130,0
30000,30000,30000,90000,60000,60000,180000,124,1
-99454,-37052,138455,1949,-421878,1577119,-1,130,0
171606,-553821,382214,-1,-1595344,1102035,-420,130,0
-98804,135855,-36402,649,1579633,-428163,836,130,0
347,-664,317,0,-1258,600,-1,124,1
0,0,0,0,0,0,0,124,1
332162,-1063440,733227,1949,-1596601,1099103,-839,130,0
21850,47314,-69165,-1,75703,-110664,0,124,1
300961,-967237,668225,1949,-1595135,1102245,-630,130,0
-512870,-569422,1086840,4548,-859048,1632420,-2,130,0
0,0,0,0,0,0,0,124,1
1017288,-770279,-246360,649,-1186035,-379984,-630,130,0
313961,-301612,-10401,1948,-1386710,-55092,-840,130,0
735177,-1060190,327612,2599,-1595344,492470,-210,130,0
-301,663,-362,0,1256,-685,0,124,1
380264,-707877,330862,3249,-1632631,760804,-212,130,0
-886634,61752,827481,2599,99290,1362410,418,130,0
-182813,-43812,226626,1,-56698,293281,1,124,1
-525220,78002,447216,-2,225183,1288466,418,130,0
0,0,0,0,0,0,0,124,1
772228,277560,-1048490,1298,414127,-1575026,627,130,0
-166407,1012087,-846332,-652,1523285,-1272547,1046,130,0
155,-637,482,0,-1206,912,-1,124,1
219708,341262,-561622,-652,987873,-1620062,418,130,0
256109,787179,-1041990,1298,1183101,-1566647,1045,130,0
-598673,-26651,627923,2599,-63890,1445152,418,130,0
995187,-876233,-118305,649,-1317374,-178262,-211,130,0
-194500,-25130,219631,1,-32521,284228,0,124,1
-63003,59302,3700,-1,94884,5921,0,124,1
-828132,-192408,1025738,5198,-291377,1537738,626,130,0
-989338,825530,166406,2598,1271499,253252,1256,130,0
248309,-344513,98803,2599,-1584871,447643,-420,130,0
-136506,40301,99453,3248,466705,1122145,418,130,0
996487,-876233,-117655,2599,-1316955,-178681,-211,130,0
102053,35751,-134556,3248,422925,-1577330,417,130,0
11,-127,116,0,-14742,13461,0,124,1
558,-202,-355,1,-5853,-10279,1,124,1
258059,786529,-1042640,1948,1181216,-1567485,1045,130,0
93603,-141056,49401,1948,-1607703,551541,-630,130,0
-598673,1069290,-468018,2599,1629906,-715769,1255,130,0
-670826,139755,533019,1948,321750,1226043,627,130,0
-156137,-80252,236390,1,-103856,305917,1,124,1
1043289,-270411,-772879,-1,-408682,-1164878,208,130,0
69840,-44499,-25340,1,-71199,-40544,1,124,1
-765079,1049789,-282761,1949,1579633,-427744,1255,130,0
-4301,-1030,5332,1,-2976,15397,1,124,1
-470,-172,642,0,-325,1215,0,124,1
-504419,679275,-173557,1299,1573349,-404702,1046,130,0
656,-418,-238,0,-792,-451,0,124,1
30000,30000,30000,90000,60000,60000,180000,124,1
143005,208657,-349064,2598,970696,-1622576,627,130,0
5656,-2828,-2828,0,-8167,-8167,0,124,1
-973087,93603,884033,4549,140137,1339787,1465,130,0
130,-112,-18,0,-12958,-2132,0,124,1
130654,-350364,221658,1948,-1615873,1016570,-421,130,0
566821,-286661,-280811,-651,-824276,-809193,-420,130,0
-954886,924984,33151,3249,1391527,46083,1255,130,0
-72153,139755,-65653,1949,1633468,-783847,1047,130,0
-99454,-36402,138455,2599,-415594,1575444,-1,130,0
284060,-327613,44851,1298,-1504224,199836,-421,130,0
109854,24050,-130655,3249,290329,-1536902,208,130,0
0,-575,575,0,-1090,1090,0,124,1
-137156,40301,99453,2598,465867,1122773,418,130,0
-657175,554470,103353,648,1282601,235237,1046,130,0
-897034,975686,-76053,2599,1470498,-118143,1256,130,0
-564872,323062,241809,-1,932781,695449,836,130,0
776,8158,-8935,-1,23309,-25528,0,124,1
24050,928234,-950986,1298,1396763,-1431956,836,130,0
70202,-890534,820330,-2,-1469032,1353403,-420,130,0
-219709,-341913,562271,649,-987874,1620480,-211,130,0
-1002988,864532,139105,649,1300825,206330,1674,130,0
65652,-143006,78002,648,-1631374,893401,-630,130,0
-369864,-185907,556420,649,-537926,1604560,-1,130,0
416665,-1079041,664974,2598,-1619434,997508,-421,130,0
3325,-5625,2300,0,-16244,6643,-1,124,1
-8008,-1034,9043,1,-2956,25838,0,124,1
549920,-393265,-156656,-1,-1132410,-453509,-630,130,0
-685776,1069940,-383515,649,1612730,-579192,628,130,0
-128055,540170,-412116,-1,1564342,-1190643,628,130,0
-8451,615573,-605823,1299,1426299,-1402420,1046,130,0
840481,172906,-1014038,-651,259117,-1525590,836,130,0
-918,-472,1390,0,-5452,16060,0,124,1
-887284,62402,826830,1948,101175,1361362,627,130,0
996487,-876233,-117655,2599,-1317584,-177633,-211,130,0
-154706,351013,-195658,649,1629906,-910788,626,130,0
367,188,-556,-1,5452,-16060,0,124,1
-178757,-375065,555120,1298,-1082765,1600580,-421,130,0
30000,30000,30000,90000,60000,60000,180000,124,1
-347114,225558,122854,1298,1050086,558873,837,130,0
119604,-663675,544720,649,-1532084,1256836,-211,130,0
4301,1030,-5332,-1,2976,-15397,-1,124,1
-665625,1072540,-404316,2599,1617757,-611870,837,130,0
284060,-327613,44851,1298,-1504224,199208,-421,130,0
-748179,1053689,-303562,1948,1587802,-460003,1045,130,0
578521,-1060840,484918,2599,-1632002,744465,-840,130,0
-1260,1186,74,0,13698,854,-1,124,1
30000,30000,30000,90000,60000,60000,180000,124,1
5587,-2027,-3559,1,-5853,-10279,1,124,1
-134556,29901,106603,1948,344373,1210752,837,130,0
-237909,-712427,951635,1299,-1176399,1569788,-420,130,0
799529,235958,-1032889,2598,353380,-1557220,627,130,0
-469,642,-172,1,1215,-325,1,124,1
-1016639,770928,248309,2598,1186662,379773,1464,130,0
1083590,-490119,-592823,648,-738182,-892564,-2,130,0
-376365,704626,-326313,1948,1632630,-759339,1046,130,0
-942536,936035,9750,3249,1409122,11730,1255,130,0
-31852,133905,-101404,649,1564970,-1188549,836,130,0
267810,-336713,70852,1949,-1548423,322797,-630,130,0
-1075791,395214,683175,2598,591760,1022645,627,130,0
-786530,-253510,1044589,4549,-383545,1566646,208,130,0
336712,-1064090,729977,2599,-1598068,1094285,-421,130,0
194500,-219631,25130,-1,-284228,32521,0,124,1
533019,-1076441,546670,3248,-1633887,828673,-211,130,0
30000,30000,30000,90000,60000,60000,180000,124,1
-362064,-344513,708526,1949,-796835,1632839,-2,130,0
842431,173556,-1014038,1949,259327,-1525800,627,130,0
0,0,0,0,0,0,0,124,1
1067339,-421866,-644175,1298,-641825,-979704,-211,130,0
382864,687075,-1068641,1298,1035632,-1611264,627,130,0
442016,-988688,547970,1298,-1630326,904712,-420,130,0
60452,-967887,911334,3899,-1457093,1368275,-2,130,0
30000,30000,30000,90000,60000,60000,180000,124,1
-91004,-438117,528469,-652,-1265634,1527265,-1,130,0
-19501,130654,-109205,1948,1523913,-1271500,836,130,0
1017938,-187208,-830732,-2,-284464,-1250343,418,130,0
16507,51291,-67798,0,82066,-108478,-1,124,1
356213,709176,-1065390,-1,1067263,-1604352,627,130,0
-154056,351013,-196308,649,1629697,-915187,1046,130,0
-374415,704626,-329563,648,1632839,-764366,1256,130,0
390,-661,270,-1,-1251,511,-1,124,1
457,-516,59,0,-14922,1707,-1,124,1
0,0,0,0,0,0,0,124,1
-36946,-33740,70686,0,-53984,113098,1,124,1
-505,-121,626,0,-229,1186,0,124,1
-110,1276,-1165,1,14742,-13461,0,124,1
274960,-1024439,751428,1949,-1577539,1156498,-211,130,0
-525220,77352,447216,-652,222878,1290142,627,130,0
279510,-703327,425765,1948,-1622157,980332,-630,130,0
-126,7,118,-1,854,13698,-1,124,1
-447867,1077740,-628574,1299,1626136,-948912,1046,130,0
173556,-554471,380914,-1,-1596601,1098474,-630,130,0
-1041990,781329,263909,3248,1175560,395274,1674,130,0
-988688,433566,555770,648,714301,915186,417,130,0
9414,-7356,-2058,0,-21019,-5880,0,124,1
-508320,986736,-481019,-2603,1633886,-792855,1464,130,0
2568,-5649,3080,-1,-16311,8896,0,124,1
-1396,506,889,-1,5853,10279,-1,124,1
-464768,692275,-226209,1298,1602884,-526405,1255,130,0
-913285,963986,-48752,1949,1451226,-75830,1045,130,0
1063439,-720878,-341263,1298,-1086116,-513837,-420,130,0
16507,51291,-67798,0,82066,-108478,-1,124,1
-675376,-393265,1074490,5849,-596369,1615243,208,130,0
841781,158605,-997788,2598,238379,-1517840,1045,130,0
1548,-9241,7693,0,-26405,21981,0,124,1
107,25,-133,-1,2976,-15397,-1,124,1
-219709,943835,-725428,-1302,1561618,-1196927,1046,130,0
300961,731277,-1030289,1949,1125287,-1587803,628,130,0
-897034,975686,-76053,2599,1470498,-118143,1256,130,0
588922,497268,-1082941,3249,746351,-1630955,627,130,0
588272,395214,-982187,1299,650203,-1622157,1046,130,0
30000,30000,30000,90000,60000,60000,180000,124,1
926934,27951,-954236,649,40218,-1434051,417,130,0
22750,109204,-131305,649,1267519,-1525800,836,130,0
-353614,180056,173556,-2,838728,794948,1045,130,0
-1060840,509619,554470,3249,783427,849830,1045,130,0
-314612,-655225,970486,649,-1082136,1600790,-210,130,0
755978,172906,-930185,-1301,284254,-1534807,417,130,0
30000,30000,30000,90000,60000,60000,180000,124,1
30000,30000,30000,90000,60000,60000,180000,124,1
334762,-1062790,731277,3249,-1597439,1096589,-211,130,0
-750779,1053039,-301612,648,1586965,-456023,1255,130,0
-1084891,491418,596072,2599,737553,893401,628,130,0
-912635,965286,-50052,2599,1453112,-79600,1256,130,0
986086,-434867,-553821,-2602,-718282,-911416,-629,130,0
92953,436166,-528470,649,1263748,-1528104,1255,130,0
148855,-921735,774179,1299,-1520563,1277154,-421,130,0
-65328,9229,56098,-1,14767,89757,-1,124,1
-428367,532369,-104654,-652,1542556,-304574,1464,130,0
1409,-801,-608,0,-9251,-7032,0,124,1
-932785,31201,905483,3899,45036,1391317,417,130,0
662,-376,-286,0,-712,-541,1,124,1
537,-420,-117,0,-12138,-3396,0,124,1
-328913,52651,278210,1948,245292,1275688,208,130,0
-37609,-186838,224447,0,-241791,290462,1,124,1
-801481,-230109,1035488,3898,-348563,1556591,836,130,0
1076440,-412116,-663025,1299,-621506,-997090,-1,130,0
-705927,393914,312661,648,911625,718491,1256,130,0
349713,-228809,-120255,649,-1047573,-561806,-629,130,0
640273,-1082941,446566,3898,-1625718,669055,-421,130,0
-233773,68281,165491,-1,88364,214165,-1,124,1
9625,-6814,-2811,0,-19469,-8033,0,124,1
942535,-212558,-731278,-1301,-350658,-1205935,-2,130,0
-382865,-663675,1049789,3249,-1023903,1613987,-1,130,0
-107,133,-25,1,15397,-2976,1,124,1
1011437,-824881,-183957,2599,-1253066,-281113,-2,130,0
658474,-556421,-100104,1949,-1283021,-233981,-211,130,0
1080340,-633124,-447217,-1,-952682,-672827,-211,130,0
219058,787179,-1007538,-1301,1214103,-1553031,627,130,0
30000,30000,30000,90000,60000,60000,180000,124,1
-141,70,70,-1,8167,8167,0,124,1
338662,-79953,-258060,649,-365111,-1196090,-211,130,0
976336,-631174,-345813,-651,-1040032,-571023,-629,130,0
-24051,-926935,954885,3899,-1395508,1433212,-211,130,0
-1001038,194357,808630,1949,298498,1241754,837,130,0
1320,4103,-5423,0,11848,-15661,0,124,1
-81254,978936,-897684,-2,1471545,-1349633,836,130,0
130004,-542771,412115,-652,-1563924,1191271,-421,130,0
-290561,1049139,-757279,1299,1582356,-1143093,836,130,0
-140406,78652,62402,648,926288,702571,1256,130,0
-960736,689025,271060,-651,1138274,446386,1465,130,0
-141313,239099,-97786,0,309422,-126546,1,124,1
75402,65652,-138456,2598,773373,-1632212,627,130,0
-890534,-51352,947085,5199,-81695,1453530,417,130,0
107,-133,25,-1,-15397,2976,-1,124,1
22100,928234,-950336,-2,1397601,-1431118,836,130,0
0,0,0,0,0,0,0,124,1
24050,927584,-950986,648,1396973,-1431746,837,130,0
-285361,-750779,1042639,6499,-1144350,1581937,-2,130,0
-656525,-418616,1079690,4549,-631351,1620271,208,130,0
-668876,-376365,1048489,3248,-581497,1612520,207,130,0
5379,-1176,-4203,0,-3396,-12138,0,124,1
496618,588922,-1084891,649,883346,-1631164,418,130,0
538220,-423166,-115055,-1,-1218503,-333062,-420,130,0
-117655,661074,-543421,-2,1532083,-1257046,1046,130,0
214508,-561622,347113,-1,-1618177,1003374,-1,130,0
-1088141,546670,544720,3249,820504,813172,1045,130,0
457617,-518720,62402,1299,-1496054,180146,-1,130,0
-194500,219631,-25130,1,284228,-32521,0,124,1
-38352,956185,-917835,-2,1442638,-1384824,1046,130,0
-1075141,395214,683825,3898,591131,1023483,1045,130,0
-132,542,-410,0,15661,-11848,0,124,1
1067990,-421216,-644825,1949,-640987,-980542,-1,130,0
32101,38511,-70613,-1,61618,-112982,-1,124,1
-1042640,780679,265859,3898,1173884,397369,1464,130,0
-656,418,238,0,792,451,0,124,1
274310,-1024439,752728,2599,-1577330,1157127,-420,130,0
-27059,70105,-43045,1,112169,-68873,1,124,1
566,17,-584,-1,32,-1106,-1,124,1
968536,-111155,-856083,1298,-173444,-1319678,-420,130,0
1084240,-618174,-464118,1948,-930059,-697754,-211,130,0
-73453,-67603,143655,2599,-774002,1632420,-2,130,0
-585672,-495969,1086840,5199,-748656,1631373,-1,130,0
182813,-226626,43812,-1,-293281,56698,-1,124,1
-136506,40951,99453,3898,469428,1120469,1046,130,0
4494,-9885,5391,0,-28245,15404,-1,124,1
456967,599322,-1056290,-1,922936,-1628232,836,130,0
-1053690,341912,715026,3248,518654,1082554,1255,130,0
889883,77352,-964637,2598,116257,-1468404,837,130,0
143005,-72153,-69553,1299,-818201,-815268,-420,130,0
-1014689,169006,847631,1948,252205,1271499,628,130,0
-369864,978286,-610373,-1951,1617967,-1006098,627,130,0
839831,141055,-978287,2599,214290,-1508832,837,130,0
753378,-1056290,304861,1949,-1587385,459164,-211,130,0
0,-8573,8573,0,-24494,24494,0,124,1
538220,-121555,-419266,-2601,-346468,-1208867,-210,130,0
366613,-557721,191757,649,-1608122,552798,-839,130,0
722827,341262,-1062790,1299,511322,-1598696,208,130,0
5040,-4744,-296,0,-13698,-854,1,124,1
579821,-643525,64352,648,-1482648,147468,-2,130,0
386114,595422,-982187,-651,982217,-1621110,417,130,0
642,-1412,770,0,-16311,8896,0,124,1
-344513,105953,240509,1949,492470,1102454,417,130,0
-437,-946,1383,0,-10929,15977,1,124,1
-141056,-209958,352963,1949,-969231,1622994,-421,130,0
1086190,-563572,-520670,1948,-850041,-783219,-630,130,0
-592,557,34,-1,1055,65,-1,124,1
140,-60,-80,0,-7032,-9251,0,124,1
35101,910034,-946436,-1301,1387128,-1440335,1465,130,0
128054,-9101,-116355,2598,-87351,-1368486,-2,130,0
1069940,-700727,-367914,1299,-1054067,-554056,-630,130,0
115704,230758,-345163,1299,1074175,-1602467,626,130,0
141705,-91004,-49402,1299,-1032282,-580449,-420,130,0
736477,-1049140,317211,4548,-1592412,479692,-2,130,0
65002,75402,-139106,1298,889630,-1630745,837,130,0
-136506,96203,40951,648,1124658,463772,836,130,0
69840,-44499,-25340,1,-71199,-40544,1,124,1
5587,-3559,-2027,1,-10279,-5853,1,124,1
-113105,-14951,131304,3248,-167579,1490817,627,130,0
-318512,24700,295111,1299,117723,1351936,417,130,0
-126,118,7,-1,13698,854,-1,124,1
-245060,341262,-95554,648,1585498,-449738,1255,130,0
287960,750778,-1038739,-1,1143301,-1581519,1046,130,0
222115,-190735,-31380,0,-246833,-40610,0,124,1
256109,85153,-338013,3249,395274,-1569789,417,130,0
30000,30000,30000,90000,60000,60000,180000,124,1
-21850,-47314,69165,1,-75703,110664,0,124,1
167056,185906,-351664,1298,867845,-1631793,836,130,0
0,0,0,0,0,0,0,124,1
-971137,65002,910684,4549,94472,1365133,627,130,0
163806,762478,-928235,-1951,1258930,-1530617,627,130,0
56124,174391,-230515,0,225683,-298314,0,124,1
0,0,0,0,0,0,0,124,1
-222115,190735,31380,0,246833,40610,0,124,1
930834,-26651,-903534,649,-43361,-1391947,208,130,0
-220359,-339963,562271,1949,-984103,1621109,-210,130,0
-549271,392614,157305,648,1134923,450575,1046,130,0
-299012,-266510,566171,649,-770441,1632420,-211,130,0
-182813,226626,-43812,1,293281,-56698,1,124,1
-558371,357513,200207,-651,1034585,577935,1046,130,0
578521,-644175,67602,1948,-1485162,152915,-420,130,0
-42902,-94904,139755,1949,-1088211,1598695,-839,130,0
-1086191,564871,523269,1949,848992,784684,1464,130,0
130004,-542771,412765,-2,-1563924,1190642,-212,130,0
11061,-66014,54952,-1,-105622,87924,0,124,1
-70492,40050,30441,-1,64081,48706,-1,124,1
233773,-165491,-68281,1,-214165,-88364,1,124,1
446566,622723,-1067991,1298,947863,-1625299,1046,130,0
343862,-248310,-93604,1948,-1143512,-438636,-630,130,0
30000,30000,30000,90000,60000,60000,180000,124,1
30000,30000,30000,90000,60000,60000,180000,124,1
-256,564,-308,0,16311,-8896,0,124,1
1004287,-867133,-136506,648,-1300616,-206122,-630,130,0
-228649,49985,178664,0,64686,231212,-1,124,1
18862,198133,-216996,-1,256407,-280818,-1,124,1
-1085541,562271,525869,2599,845431,788036,1046,130,0
-47452,-912635,963336,3249,-1376655,1450179,-1,130,0
0,0,0,0,0,0,0,124,1
9145,-7853,-1292,0,-22439,-3691,1,124,1
919784,-919135,650,1299,-1414988,0,-838,130,0
-107255,-880783,991287,3249,-1326800,1488931,-420,130,0
143655,-72153,-68903,2599,-819458,-814011,-630,130,0
540170,-122855,-417966,-651,-350658,-1206144,-211,130,0
0,0,0,0,0,0,0,124,1
706576,-393265,-313312,-1,-905970,-724148,-421,130,0
419265,659774,-1076441,2598,991643,-1619643,627,130,0
0,1224,-1224,0,14145,-14145,0,124,1
68756,-48674,-20082,0,-77878,-32132,1,124,1
625973,-29252,-597373,-652,-66194,-1380216,-211,130,0
273010,-1023789,753378,2599,-1576911,1158383,-212,130,0
-263910,334112,-68903,1299,1548422,-322379,837,130,0
255459,-564872,311361,1948,-1630745,899894,-211,130,0
703326,249609,-954886,-1951,411194,-1574397,208,130,0
671475,-1064740,397814,4549,-1616292,602233,-212,130,0
8440,259,-8699,0,740,-24856,0,124,1
-945136,217108,730627,2599,355894,1203001,837,130,0
65002,-642225,579171,1948,-1482858,1334969,-630,130,0
-863233,1001687,-135856,2598,1507574,-208007,1255,130,0
-70492,40050,30441,-1,64081,48706,-1,124,1
-328913,560971,-232059,-1,1625926,-672408,1045,130,0
0,0,0,0,0,0,0,124,1
92953,436166,-528470,649,1264167,-1527894,1046,130,0
63003,-3700,-59302,1,-5921,-94884,0,124,1
-122855,993237,-869733,649,1498148,-1312556,1256,130,0
5379,-4203,-1176,0,-12138,-3396,0,124,1
599972,456317,-1056290,-1,701733,-1627813,417,130,0
-840482,-156006,1001687,5199,-239009,1519095,836,130,0
-605173,-451117,1058889,2599,-697545,1628021,417,130,0
0,0,0,0,0,0,0,124,1
330862,-707877,379614,2599,-1632421,871825,-630,130,0
638323,-975687,338012,648,-1608960,558873,-420,130,0
-456968,-622074,1081640,2598,-938648,1627183,207,130,0
455017,533019,-988688,-652,880413,-1631164,837,130,0
-939936,742327,195657,-1952,1226253,322168,1046,130,0
-141,70,70,-1,8167,8167,0,124,1
-726078,-320463,1051739,5198,-489119,1594296,208,130,0
237456,-86157,-151298,1,-111497,-195798,1,124,1
390,270,-661,-1,511,-1251,-1,124,1
-5040,296,4744,0,854,13698,-1,124,1
-1084241,469967,617523,3249,705294,923565,1046,130,0
377664,668225,-1046540,-651,1028720,-1612521,1046,130,0
30000,30000,30000,90000,60000,60000,180000,124,1
0,-8573,8573,0,-24494,24494,0,124,1
492068,190457,-684476,-1951,443244,-1582776,208,130,0
233773,-68281,-165491,1,-88364,-214165,1,124,1
980886,-875583,-103354,1949,-1328895,-158781,-420,130,0
-970487,61102,912634,3249,89654,1367647,627,130,0
0,0,0,0,0,0,0,124,1
30000,30000,30000,90000,60000,60000,180000,124,1
-430,-103,533,0,-2976,15397,1,124,1
1041989,-356214,-685776,-1,-550495,-1056371,-420,130,0
754678,-1056290,304211,2599,-1587175,457278,-421,130,0
697476,-247010,-449817,649,-570395,-1040451,-630,130,0
-271711,-59153,333462,2598,-271477,1530407,418,130,0
-726728,-319812,1051739,5199,-488281,1594296,418,130,0
-368564,976986,-611023,-2601,1617548,-1008193,1046,130,0
84503,-141706,59802,2599,-1625299,668846,-420,130,0
-523920,1082290,-558371,-1,1633677,-842709,1255,130,0
315261,655224,-969837,648,1080041,-1600791,418,130,0
-536921,421215,115704,-2,1219340,332433,1046,130,0
-70853,888583,-818381,-651,1470079,-1352147,836,130,0
-337363,79302,260009,1948,370557,1192318,418,130,0
-891184,-90354,984786,3248,-137834,1478248,417,130,0
-1076441,653924,427065,4548,983055,638891,1465,130,0
124154,-993888,873632,3898,-1497940,1314022,417,130,0
-1748,-3785,5533,0,-10929,15977,1,124,1
-541471,663024,-119605,1948,1534387,-280694,1255,130,0
-141313,-97786,239099,0,-126546,309422,1,124,1
365313,-557721,193057,649,-1608960,558244,-630,130,0
-229459,1032888,-801481,1948,1556172,-1208239,1255,130,0
-1414,707,707,0,8167,8167,0,124,1
854131,154055,-1004938,3248,228744,-1514697,418,130,0
272360,57852,-330213,-1,272942,-1530617,417,130,0
0,0,0,0,0,0,0,124,1
967886,-915885,-50702,1299,-1374979,-76668,-421,130,0
1080990,-633124,-447217,649,-952473,-673036,-211,130,0
-18862,216996,-198133,1,280818,-256407,1,124,1
-28602,930834,-902884,-652,1436354,-1391947,836,130,0
-566,584,-17,1,1106,-32,1,124,1
109146,-240086,130940,0,-310700,169451,-1,124,1
-1073841,568121,508969,3249,863865,769602,1674,130,0
0,0,0,0,0,0,0,124,1
-442017,985436,-545371,-1952,1630954,-899057,837,130,0
0,-575,575,0,-1090,1090,0,124,1
30000,30000,30000,90000,60000,60000,180000,124,1
1075140,-497269,-576572,1299,-755987,-875806,-1,130,0
-828132,-193058,1026388,5198,-292424,1537948,418,130,0
-1068641,702676,369213,3248,1055742,552170,1256,130,0
4494,5391,-9885,0,15404,-28245,-1,124,1
-511570,-572022,1086840,3248,-862609,1632420,-2,130,0
-978937,85153,898983,5199,124845,1348166,836,130,0
-380915,-687076,1072540,4549,-1037100,1611682,-2,130,0
798879,-908085,111154,1948,-1497521,183707,-421,130,0
-1025089,823580,204107,2598,1238611,303525,1254,130,0
30000,30000,30000,90000,60000,60000,180000,124,1
-174,553,-378,1,15977,-10929,1,124,1
156137,-236390,80252,-1,-305917,103856,-1,124,1
30000,30000,30000,90000,60000,60000,180000,124,1
-103,620,-516,1,1175,-978,1,124,1
956835,-926285,-30552,-2,-1391318,-46084,-420,130,0
-670826,138455,533669,1298,319445,1227509,626,130,0
656524,419915,-1075791,648,630093,-1619853,417,130,0
5587,-2027,-3559,1,-5853,-10279,1,124,1
432266,99453,-531720,-1,289072,-1536483,208,130,0
0,0,0,0,0,0,0,124,1
4494,5391,-9885,0,15404,-28245,-1,124,1
74752,66302,-139106,1948,779447,-1632421,627,130,0
-988038,568771,418615,-652,938856,688955,1255,130,0
354913,-183957,-169657,1299,-843756,-789294,-211,130,0
5818,-9845,4026,-1,-28129,11504,0,124,1
-747529,934735,-187208,-2,1544861,-310439,1465,130,0
291210,27951,-319162,-1,138251,-1478249,208,130,0
-211908,559020,-346463,649,1618176,-1003165,418,130,0
0,0,0,0,0,0,0,124,1
973736,-94254,-878183,1299,-143699,-1336855,208,130,0
557720,-358814,-200208,-1302,-1036052,-575841,-630,130,0
938635,-743628,-195658,-651,-1226044,-321960,-630,130,0
-245060,341912,-95554,1298,1585498,-449529,1464,130,0
-137156,40301,99453,2598,470475,1119422,627,130,0
926284,26650,-953586,-652,38752,-1433213,208,130,0
1004937,-146906,-858683,-652,-222251,-1289933,208,130,0
332162,-1062790,733227,2599,-1596392,1099522,-420,130,0
7527,1804,-9331,0,5154,-26661,0,124,1
-506369,35101,473217,1949,99290,1362410,628,130,0
117004,230108,-345813,1299,1069777,-1603514,627,130,0
418615,660424,-1076441,2598,992062,-1619434,836,130,0
419915,659124,-1077091,1948,988711,-1619853,418,130,0
399114,-548621,150155,648,-1580262,430466,-629,130,0
378964,668875,-1046540,1299,1028720,-1612731,836,130,0
-223609,347763,-122855,1299,1611892,-574375,836,130,0
787179,243109,-1027039,3249,367834,-1561619,628,130,0
-52,-547,599,0,-1037,1136,1,124,1
290560,29251,-319162,649,142650,-1480135,207,130,0
-402366,-144306,546670,-2,-415175,1575653,208,130,0
841781,159905,-999088,2598,240684,-1518887,837,130,0
0,0,0,0,0,0,0,124,1
-1051090,765078,287310,1298,1151052,428790,1255,130,0
220358,787179,-1008188,-651,1213265,-1553450,1255,130,0
-317862,24050,295761,1949,111229,1355497,417,130,0
1144,-1291,147,0,-14922,1707,-1,124,1
-577222,640924,-62403,1299,1483695,-148517,1674,130,0
-102054,342562,-239209,1299,1592411,-1112091,837,130,0
-945136,215158,731927,1949,353170,1204886,1045,130,0
131304,-114405,-16901,-2,-1300197,-206960,-839,130,0
-83204,524569,-442017,-652,1520352,-1277365,836,130,0
-155,637,-482,0,1206,-912,1,124,1
0,0,0,0,0,0,0,124,1
986736,-434867,-553171,-1302,-718492,-911416,-839,130,0
-973737,94253,883383,3899,140765,1339368,1255,130,0
69840,-44499,-25340,1,-71199,-40544,1,124,1
3059,6624,-9683,0,18925,-27666,-1,124,1
-1075791,393264,685125,2598,588618,1025578,837,130,0
-328263,560971,-233359,-651,1626136,-675340,837,130,0
-32502,134555,-102054,-1,1564551,-1189805,837,130,0
-564222,324362,239858,-2,936552,691678,1465,130,0
30000,30000,30000,90000,60000,60000,180000,124,1
-614,527,86,-1,998,164,0,124,1
648074,322412,-971137,-651,530384,-1602676,417,130,0
-759879,-170957,931484,648,-284464,1535434,837,130,0
1017938,-770929,-243760,3249,-1187711,-377470,-630,130,0
-91,139,-47,1,16060,-5452,0,124,1
-88,528,-439,1,15249,-12694,0,124,1
1041989,-352964,-688376,649,-545677,-1060561,-630,130,0
3673,-5562,1888,-1,-16060,5452,0,124,1
30000,30000,30000,90000,60000,60000,180000,124,1
-1396,506,889,-1,5853,10279,-1,124,1
128054,-8451,-116355,3248,-85675,-1369533,-211,130,0
477117,-1083591,611022,4548,-1629489,917490,-421,130,0
0,0,0,0,0,0,0,124,1
-465418,691625,-225559,648,1602466,-524520,1256,130,0
256,308,-564,0,8896,-16311,0,124,1
-1056290,432266,626623,2599,663818,960851,836,130,0
30000,30000,30000,90000,60000,60000,180000,124,1
939935,-741028,-199558,-651,-1222483,-327197,-630,130,0
785879,257409,-1040039,3249,383963,-1566437,418,130,0
950335,-20801,-926935,2599,-34145,-1396974,207,130,0
-254,-404,658,0,-766,1247,0,124,1
-521320,450466,70202,-652,1303339,201931,1256,130,0
-939936,742327,196307,-1302,1226462,322378,1255,130,0
-248310,1039388,-791080,-2,1564342,-1189805,837,130,0
289260,-1049140,763778,3898,-1580472,1148329,-420,130,0
-935386,13000,926934,4548,16757,1406190,627,130,0
690325,-482969,-206708,648,-1112091,-480321,-420,130,0
0,0,0,0,0,0,0,124,1
-933435,11700,928234,6499,15082,1407237,837,130,0
0,0,0,0,0,0,0,124,1
1058239,-749479,-306162,2598,-1126545,-461678,-630,130,0
983486,-889234,-92954,1298,-1339788,-139719,-421,130,0
530419,137155,-668876,-1302,320074,-1546956,208,130,0
788479,240509,-1026389,2599,364063,-1560363,836,130,0
-421216,-656525,1080990,3249,-988083,1620480,208,130,0
948385,-14951,-929535,3899,-26604,-1400744,208,130,0
266509,-337363,72152,1298,-1550517,328662,-630,130,0
335412,-1064090,731277,2599,-1597020,1096798,-211,130,0
851531,-1009488,159905,1948,-1519725,240474,-211,130,0
-46152,-912635,963336,4549,-1377702,1449132,-420,130,0
-55253,-889234,947085,2598,-1369952,1455416,-420,130,0
102053,554470,-655225,1298,1284277,-1515954,1047,130,0
513519,572021,-1084241,1299,859675,-1632002,836,130,0
-893134,961386,-65653,2599,1463795,-103061,1256,130,0
-1068641,703326,367263,1948,1057208,550284,1045,130,0
-3673,-1888,5562,1,-5452,16060,0,124,1
-428367,532369,-105304,-1302,1542766,-304574,1465,130,0
11,-127,116,0,-14742,13461,0,124,1
27059,-70105,43045,-1,-112169,68873,-1,124,1
9899,-4949,-4949,1,-14142,-14142,0,124,1
-254,-404,658,0,-766,1247,0,124,1
358163,710476,-1065390,3249,1067472,-1604352,417,130,0
648074,324362,-971137,1299,533526,-1603304,208,130,0
-746228,934735,-188508,-1,1545280,-312743,1047,130,0
1017938,-187208,-830082,648,-285512,-1249715,417,130,0
-273011,-57853,333462,2598,-267078,1528941,418,130,0
-1076441,414065,664974,2598,622343,996671,628,130,0
-3673,5562,-1888,1,16060,-5452,0,124,1
11700,115054,-125455,1299,1346280,-1474060,836,130,0
-16507,-51291,67798,0,-82066,108478,1,124,1
493368,189157,-683826,-1301,439264,-1581938,-1,130,0
143005,-72153,-68903,1949,-817572,-815687,-210,130,0
-2568,-3080,5649,1,-8896,16311,0,124,1
512219,572671,-1084241,649,861770,-1632212,836,130,0
273660,56552,-330213,-1,269591,-1529570,208,130,0
135205,863882,-998438,649,1302710,-1504643,1255,130,0
769628,-1053040,286010,2598,-1579425,427952,-212,130,0
880132,110504,-990638,-2,164855,-1489351,418,130,0
237456,-86157,-151298,1,-111497,-195798,1,124,1
-656,418,238,0,792,451,0,124,1
349713,-228809,-120255,649,-1047364,-562016,-630,130,0
-177457,351663,-173557,649,1634096,-806889,1465,130,0
521969,553170,-1073841,1298,839985,-1632631,1046,130,0
-126,118,7,-1,13698,854,-1,124,1
0,0,0,0,0,0,0,124,1
41562,-70323,28760,-1,-112517,46016,-1,124,1
-479718,498568,-18201,649,1441800,-54673,1046,130,0
528469,531719,-1058890,1298,817152,-1633050,417,130,0
-139106,50051,90353,1298,588408,1025578,836,130,0
30000,30000,30000,90000,60000,60000,180000,124,1
-10401,-117005,129354,1948,-1344815,1475106,-211,130,0
789779,218408,-1006238,1949,333899,-1551146,417,130,0
-1004938,176806,833331,5199,267496,1262282,1465,130,0
-559021,207357,353613,1949,595530,1019503,417,130,0
-256110,-785880,1043939,1949,-1183312,1566855,-211,130,0
30000,30000,30000,90000,60000,60000,180000,124,1
558370,-358814,-200858,-1302,-1033748,-578564,-420,130,0
144305,-919785,776779,1299,-1518677,1280925,-1,130,0
-988038,109854,883383,5199,161712,1327218,1045,130,0
851531,-1010788,161206,1949,-1520144,241940,-2,130,0
-1032889,264559,774829,6499,398835,1172628,1046,130,0
-441367,986086,-545371,-652,1630954,-900733,837,130,0
194500,-219631,25130,-1,-284228,32521,0,124,1
-1076441,655224,424465,3248,984731,636796,1255,130,0
-1396,506,889,-1,5853,10279,-1,124,1
-11,-116,127,0,-13461,14742,0,124,1
928234,24050,-952286,-2,34353,-1431327,208,130,0
709826,-1040039,332162,1949,-1599534,510694,-630,130,0
56552,887283,-944486,-651,1369322,-1455836,1045,130,0
0,0,0,0,0,0,0,124,1
30000,30000,30000,90000,60000,60000,180000,124,1
22750,108554,-130655,649,1268566,-1525381,1045,130,0
-399,546,-146,1,15777,-4227,1,124,1
897683,-964637,68902,1948,-1463796,103898,-2,130,0
30000,30000,30000,90000,60000,60000,180000,124,1
940585,-741028,-199558,-1,-1222064,-327825,-420,130,0
-289261,-30552,322412,2599,-140976,1479505,208,130,0
770928,280810,-1049790,1948,419154,-1576492,208,130,0
731277,300311,-1030289,1299,460839,-1587175,208,130,0
-1748,-3785,5533,0,-10929,15977,1,124,1
332,230,-562,0,6643,-16244,-1,124,1
-573972,983486,-410816,-1302,1626555,-678692,836,130,0
-297062,1040038,-742978,-2,1586127,-1132200,1256,130,0
272360,-1023789,754678,3249,-1576492,1159640,-630,130,0
115704,14300,-128055,1949,166740,-1490189,418,130,0
70492,-30441,-40050,1,-48706,-64081,1,124,1
-241810,-709827,952935,1298,-1172210,1571254,-211,130,0
-128705,540170,-411466,-1,1564760,-1189596,1045,130,0
259359,304861,-566172,-1952,883346,-1631374,-2,130,0
-657825,-418616,1079690,3249,-631142,1620061,-2,130,0
677325,397164,-1071241,3248,595949,-1614616,208,130,0
4823,148,-4971,0,427,-14354,0,124,1
3788,-9814,6026,0,-28042,17218,-1,124,1
963986,-289261,-675376,-651,-478646,-1113138,-420,130,0
63003,-3700,-59302,1,-5921,-94884,0,124,1
-338013,79302,260009,1298,369719,1193156,627,130,0
-659125,-400416,1067339,7798,-612499,1617967,418,130,0
289910,29251,-319162,-1,140137,-1479087,-1,130,0
-312012,1054989,-741678,1299,1590526,-1118794,837,130,0
-244410,341262,-96204,648,1585917,-452043,1045,130,0
306811,1300,-306162,1949,12777,-1420854,-2,130,0
1023788,-274961,-749479,-652,-423345,-1154614,-630,130,0
-527170,-462818,989337,-651,-764157,1632211,208,130,0
-881434,-109205,994537,3898,-165693,1490188,627,130,0
136505,-31202,-104004,1299,-339556,-1213685,-2,130,0
75402,65652,-138456,2598,775048,-1632212,836,130,0
-891834,-87754,984136,4548,-134482,1476991,626,130,0
-1051090,766378,286660,1948,1151890,427533,1046,130,0
1056939,-751429,-304212,1298,-1129268,-457489,-211,130,0
-406916,-295762,706576,3898,-686024,1626764,417,130,0
-3673,5562,-1888,1,16060,-5452,0,124,1
0,0,0,0,0,0,0,124,1
-961387,689025,271060,-1302,1137855,446595,1045,130,0
-297062,-267811,566171,1298,-773583,1632630,-1,130,0
87753,807980,-897684,-1951,1336016,-1481810,836,130,0
190457,-998438,810580,2599,-1537949,1246153,-211,130,0
116354,-130655,16900,2599,-1492703,171139,-211,130,0
9100,300961,-306812,3249,1398439,-1430071,1255,130,0
53768,-66654,12885,-1,-106647,20617,0,124,1
-311362,298361,13650,649,1386080,56348,1255,130,0
950335,-18851,-927585,3899,-32259,-1397812,208,130,0
349713,-230109,-118955,649,-1053020,-555732,-1259,130,0
-228649,178664,49985,0,231212,64686,-1,124,1
-7000,-2562,9562,0,-7320,27320,0,124,1
148205,-1005588,860632,3249,-1511765,1292027,-2,130,0
230108,-1034839,806680,1949,-1554916,1211590,-210,130,0
522,-73,-448,1,-2132,-12958,0,124,1
-9414,7356,2058,0,21019,5880,0,124,1
455017,601272,-1056290,-1,925450,-1628022,627,130,0
454367,601272,-1055640,-1,925659,-1628022,627,130,0
-46802,951635,-904184,649,1449760,-1376655,836,130,0
41562,28760,-70323,-1,46016,-112517,-1,124,1
-139,50,88,-1,5853,10279,-1,124,1
658474,417965,-1076441,-2,628418,-1619434,627,130,0
-452417,1067990,-614274,1299,1627602,-935715,1465,130,0
18862,198133,-216996,-1,256407,-280818,-1,124,1
823580,-992588,170956,1948,-1527685,262259,-211,130,0
-614924,1080990,-464118,1948,1628650,-700477,1465,130,0
1037438,-711777,-325013,648,-1095752,-501269,-630,130,0
985436,-101404,-884034,-2,-155639,-1330362,-212,130,0
53768,-66654,12885,-1,-106647,20617,0,124,1
131304,865182,-997138,-652,1304386,-1503595,837,130,0
30000,30000,30000,90000,60000,60000,180000,124,1
204988,6293,-211281,0,8144,-273423,0,124,1
-108555,-880133,991937,3249,-1325753,1489560,-1,130,0
30000,30000,30000,90000,60000,60000,180000,124,1
0,0,0,0,0,0,0,124,1
572021,514819,-1085541,1299,772954,-1632212,836,130,0
-205,-444,650,1,-842,1231,1,124,1
141705,209307,-348414,2598,974047,-1622157,836,130,0
-172907,678625,-504419,1299,1572720,-1169696,1045,130,0
-656,238,418,0,451,792,0,124,1
408215,295761,-702677,1299,685813,-1626137,836,130,0
964636,-290561,-674076,-1,-480740,-1111672,-630,130,0
-592,557,34,-1,1055,65,-1,124,1
171606,-553821,382864,649,-1595344,1102454,-630,130,0
658474,-557071,-99454,1949,-1283859,-232725,-212,130,0
642,-1412,770,0,-16311,8896,0,124,1
-738,-674,1413,1,-7793,16328,1,124,1
-1043290,781329,264559,2598,1174932,395903,1256,130,0
-16507,67798,-51291,0,108478,-82066,1,124,1
459567,-1071891,617523,5199,-1627813,935923,-2,130,0
-128055,540170,-411466,649,1564342,-1190015,837,130,0
4000,1464,-5464,0,4227,-15777,0,124,1
-37052,-910035,951635,4548,-1383777,1444104,-211,130,0
254159,-1042640,791079,2598,-1566018,1186662,-211,130,0
-564222,323712,241809,1299,933410,695030,1256,130,0
-9101,126104,-115705,1298,1472174,-1349005,836,130,0
16507,-67798,51291,0,-108478,82066,-1,124,1
828131,193707,-1021839,-1,289072,-1536273,627,130,0
33,102,-135,0,11848,-15661,0,124,1
451116,243759,-694877,-2,565157,-1609379,418,130,0
-1375,973,401,-1,11243,4639,0,124,1
-192408,-828782,1023788,2598,-1248248,1536691,-420,130,0
-349714,133254,219708,3248,615849,1002536,836,130,0
-685126,1070590,-384165,1299,1612939,-580240,1046,130,0
30000,30000,30000,90000,60000,60000,180000,124,1
139105,-41602,-96854,649,-468800,-1120679,-420,130,0
-141313,239099,-97786,0,309422,-126546,1,124,1
116354,13650,-127405,2599,168206,-1490608,627,130,0
161206,763778,-926935,-1951,1261863,-1529151,837,130,0
-350364,132604,220358,2598,615221,1002745,627,130,0
-141056,70202,72152,1298,823646,810030,1045,130,0
5040,-4744,-296,0,-13698,-854,1,124,1
-341263,246359,96853,1949,1145606,435912,1046,130,0
-45502,950985,-904184,1299,1448713,-1377912,1046,130,0
-170957,551870,-380265,648,1596810,-1098056,837,130,0
-18862,216996,-198133,1,280818,-256407,1,124,1
-1000,-366,1366,0,-4227,15777,0,124,1
280160,-702677,425765,3248,-1622157,980122,-421,130,0
813180,-1032889,222308,2599,-1551984,333689,-212,130,0
1144,147,-1291,0,1707,-14922,-1,124,1
-74292,-160869,235162,1,-208184,304328,1,124,1
492718,191107,-685126,-1301,445338,-1583195,627,130,0
-70710,35355,35355,0,56568,56568,-1,124,1
83853,56552,-139106,1299,661724,-1623623,837,130,0
-1084891,472567,615573,3249,708855,920632,1255,130,0
425765,-703977,280160,1948,-1622366,644547,-210,130,0
2568,3080,-5649,-1,8896,-16311,0,124,1
668875,-137806,-530420,649,-317771,-1228558,-212,130,0
-9145,7853,1292,0,22439,3691,-1,124,1
-1041990,781979,263259,3248,1176608,393389,1256,130,0
1056939,-312012,-745578,-651,-469848,-1120051,-421,130,0
-124155,117654,8450,1949,1373721,79599,1464,130,0
80603,-978937,900283,1949,-1470708,1351308,-211,130,0
45501,-139756,96853,2598,-1597020,1097217,-630,130,0
-261960,-304862,565521,-1301,-878110,1632001,208,130,0
-903534,-64353,973086,5199,-100338,1462328,1045,130,0
-225559,691625,-464768,1298,1602675,-1076481,1045,130,0
156137,80252,-236390,-1,103856,-305917,-1,124,1
214212,-12582,-201630,0,-16283,-260933,0,124,1
359463,708526,-1066040,1949,1065378,-1604771,627,130,0
-614924,1080990,-463468,2598,1628440,-699220,1255,130,0
-1003638,865182,137805,-651,1301872,204445,1465,130,0
759228,169656,-928235,649,279227,-1532712,627,130,0
30000,30000,30000,90000,60000,60000,180000,124,1
668875,379614,-1045890,2599,582334,-1612102,418,130,0
27059,43045,-70105,-1,68873,-112169,-1,124,1
-20801,-928885,952935,3249,-1398021,1430907,-630,130,0
-5379,4203,1176,0,12138,3396,0,124,1
1260,-74,-1186,0,-854,-13698,1,124,1
-255460,-785230,1043939,3249,-1183102,1566855,-420,130,0
-234009,-112455,349063,2599,-516770,1599952,-2,130,0
-738,-674,1413,1,-7793,16328,1,124,1
-971137,114404,859332,2599,173862,1319468,627,130,0
-749479,1053689,-302912,1298,1587593,-458536,1046,130,0
-5040,4744,296,0,13698,854,-1,124,1
482,-497,14,-1,-14354,427,0,124,1
-134556,30551,107254,3249,345001,1210123,627,130,0
-1032889,769628,269110,5849,1168648,405120,1466,130,0
550,-389,-160,1,-11243,-4639,0,124,1
-1084241,510919,575921,2599,768555,864493,1255,130,0
-291861,564221,-272361,-1,1633468,-787408,837,130,0
91003,248959,-339963,-1,1162573,-1574607,836,130,0
-522,73,448,-1,2132,12958,0,124,1
-126,7,118,-1,854,13698,-1,124,1
918,472,-1390,0,5452,-16060,0,124,1
-169999,232224,-62224,1,300525,-80525,1,124,1
-709177,1036138,-326313,648,1598276,-504201,1465,130,0
-698127,247009,453066,1948,568508,1041917,627,130,0
-144306,917834,-775480,-1952,1518886,-1280298,627,130,0
-1144,-147,1291,0,-1707,14922,1,124,1
-5639,2435,3204,0,7032,9251,0,124,1
-636374,1079040,-442667,-1,1625298,-666752,836,130,0
258709,304861,-565522,-1952,882717,-1631164,417,130,0
85153,55902,-138456,2599,659420,-1623414,627,130,0
-133906,29901,107254,3249,341440,1212637,837,130,0
703976,-297712,-406266,-2,-686233,-940533,-421,130,0
-368564,976986,-611023,-2601,1617338,-1008193,626,130,0
-156137,-80252,236390,1,-103856,305917,1,124,1
30000,30000,30000,90000,60000,60000,180000,124,1
-2310,9491,-7180,1,27119,-20516,1,124,1
-565,282,282,-1,8167,8167,0,124,1
204988,-211281,6293,0,-273423,8144,0,124,1
-137806,40951,99453,2598,471313,1118793,627,130,0
240416,-120208,-120208,0,-155563,-155563,0,124,1
-1344,294,1050,0,3396,12138,0,124,1
-980887,366613,616223,1949,601815,1014476,837,130,0
-1006238,178756,832031,4549,270219,1260397,1255,130,0
-769629,1015988,-245060,1299,1566436,-380822,1255,130,0
330,-1355,1025,0,-15661,11848,0,124,1
26650,926284,-952286,648,1394459,-1434051,1045,130,0
-124155,117004,9100,1949,1371417,83998,1465,130,0
-551871,165106,386764,-1,476759,1114604,417,130,0
-1052390,650024,404965,2599,998975,620248,1046,130,0
-1076441,657174,422515,3248,987454,633864,1465,130,0
-130,112,18,0,12958,2132,0,124,1
-107,133,-25,1,15397,-2976,1,124,1
-113755,-14301,130654,2598,-164646,1489560,837,130,0
-700077,438116,263259,1298,1013219,603281,1046,130,0
888583,56552,-944486,649,86093,-1455417,208,130,0
7527,-9331,1804,0,-26661,5154,0,124,1
505718,-34452,-473218,-1952,-95520,-1364296,-211,130,0
-948386,22750,930834,5198,31420,1398649,836,130,0
998437,-192408,-805381,648,-297871,-1241755,-212,130,0
143005,837881,-980237,649,1292446,-1511136,1046,130,0
696176,-243760,-452417,-1,-563273,-1046107,-421,130,0
-221009,-339963,562271,1299,-983265,1621318,-1,130,0
-400,-146,546,0,-4227,15777,0,124,1
-148206,919134,-773529,-2601,1521400,-1276318,1255,130,0
44,466,-510,0,13461,-14742,0,124,1
-1085541,618823,468017,1299,928382,700267,1255,130,0
48751,462817,-511570,-2,1339996,-1478878,626,130,0
-297712,964636,-667576,-652,1595343,-1102665,836,130,0
550570,-1086841,540820,4549,-1633887,810449,-420,130,0
75402,-143006,68902,1298,-1633259,781333,-420,130,0
1067990,-638324,-429017,649,-970697,-652508,-2,130,0
-1056940,435516,623373,1949,668636,956661,836,130,0
-705277,393914,313961,2598,910158,719957,1255,130,0
-924335,957485,-31852,1298,1439286,-49855,1255,130,0
-20801,-110505,133905,2599,-1266472,1526636,-211,130,0
-139106,50701,90353,1948,590503,1023902,836,130,0
-9868,5607,4261,0,16020,12176,-1,124,1
10400,850231,-862583,-1952,1405561,-1423577,417,130,0
-925635,957485,-31852,-2,1439286,-49855,1255,130,0
521969,466067,-989338,-1302,769602,-1632212,207,130,0
788479,221658,-1007538,2599,338717,-1552612,627,130,0
-219059,943835,-725428,-652,1561409,-1197346,1046,130,0
-683826,1070590,-385465,1299,1613358,-582125,1255,130,0
-48752,951635,-903534,-651,1450807,-1375398,836,130,0
-5172,-4723,9896,1,-13496,28274,0,124,1
25350,926934,-951636,648,1395716,-1433003,1255,130,0
-310712,299661,13000,1949,1387756,52996,1255,130,0
-169007,550570,-382215,-652,1595134,-1103293,627,130,0
-33152,134555,-100754,649,1566227,-1184987,628,130,0
390,270,-661,-1,511,-1251,-1,124,1
30000,30000,30000,90000,60000,60000,180000,124,1
408865,294461,-703327,-1,681414,-1625718,627,130,0
9868,-5607,-4261,0,-16020,-12176,1,124,1
-73453,-67603,143655,2599,-774630,1632420,-1,130,0
181356,-354264,175506,2598,-1633887,804794,-420,130,0
64,77,-141,0,8896,-16311,0,124,1
-125617,-114716,240333,0,-148456,311020,1,124,1
-1320,5423,-4103,0,15661,-11848,0,124,1
-648725,81903,569421,2599,189782,1310251,836,130,0
0,0,0,0,0,0,0,124,1
0,208206,-208206,0,269443,-269443,0,124,1
-365314,555120,-189808,-2,1607912,-551752,836,130,0
-73,-67,141,1,-7793,16328,1,124,1
221,-1320,1099,0,-15249,12694,0,124,1
0,-61237,61237,0,-97979,97979,0,124,1
-1078391,434866,646124,2599,652716,970905,1464,130,0
43,94,-138,-1,10929,-15977,-1,124,1
-99454,-555771,657824,2599,-1284278,1516163,-2,130,0
37609,186838,-224447,0,241791,-290462,-1,124,1
-605173,-474518,1083590,3899,-715978,1629697,627,130,0
-1065390,357513,712426,4549,535202,1068939,837,130,0
-571372,-513520,1088140,3248,-773164,1632630,209,130,0
1084890,-562922,-521970,-2,-847946,-785104,-211,130,0
30000,30000,30000,90000,60000,60000,180000,124,1
-421866,700726,-277561,1299,1622784,-646014,1255,130,0
1066689,-422516,-643525,648,-642244,-979495,-211,130,0
911984,-791730,-120255,-1,-1306272,-196276,-420,130,0
-614,527,86,-1,998,164,0,124,1
-9145,1292,7853,0,3691,22439,-1,124,1
2955,-5654,2699,0,-16328,7793,-1,124,1
-658475,-401716,1066689,6498,-613127,1617967,418,130,0
-689676,479067,212557,1948,1108529,484929,1046,130,0
139,-50,-88,1,-5853,-10279,1,124,1
-59803,-272361,334112,1948,-1252228,1534596,-211,130,0
-287961,-750129,1043289,5199,-1143093,1582356,-2,130,0
456967,-1071891,619473,4549,-1627394,939275,-211,130,0
-2601,-488819,492718,1298,-1409123,1420434,-210,130,0
-537571,421865,115704,-2,1220387,331176,1255,130,0
-70492,40050,30441,-1,64081,48706,-1,124,1
8820,-8302,-518,0,-23721,-1480,0,124,1
0,0,0,0,0,0,0,124,1
0,0,0,0,0,0,0,124,1
-277561,-768979,1049139,2599,-1159222,1576281,-421,130,0
-671476,141055,531719,1298,323216,1224996,627,130,0
670175,-140406,-529120,649,-322379,-1225206,208,130,0
-1058240,750128,309411,1299,1126544,461677,1046,130,0
-401066,-144956,546670,648,-416432,1576072,208,130,0
913284,-790430,-121555,1299,-1304177,-199628,-420,130,0
1033538,-260010,-771579,1949,-397161,-1173048,207,130,0
373113,-1067991,699426,4548,-1608751,1051971,-421,130,0
-22,-109,132,1,-12694,15249,0,124,1
976986,-629874,-346463,649,-1040451,-570814,-839,130,0
-4494,9885,-5391,0,28245,-15404,1,124,1
119604,861932,-983487,-1951,1314231,-1496892,1046,130,0
-98804,135855,-35752,1299,1578376,-422507,1465,130,0
-141056,-210608,352963,1299,-970906,1622784,-420,130,0
-533670,-135856,670825,1299,-315047,1545489,418,130,0
891833,74102,-963337,2598,111020,-1466309,627,130,0
-74753,335412,-258710,1949,1557429,-1205725,627,130,0
0,0,0,0,0,0,0,124,1
805380,95553,-900284,649,156057,-1485581,627,130,0
-46152,950335,-904834,-651,1448294,-1378121,1256,130,0
-5040,4744,296,0,13698,854,-1,124,1
-141056,-211908,352963,-1,-972582,1622575,-420,130,0
696826,-246360,-449817,649,-568090,-1042127,-420,130,0
425115,-703327,282110,3898,-1622995,648317,-631,130,0
-143656,1002987,-858033,1298,1511135,-1292866,1045,130,0
-458918,-529120,989337,1299,-874339,1632001,-1,130,0
-1040039,250259,793029,3249,374956,1189595,1046,130,0
-40302,507018,-468018,-1302,1470079,-1352147,1046,130,0
-140406,59802,80603,-1,706970,921889,837,130,0
648074,-1053690,407565,1949,-1620062,626532,-839,130,0
431616,-1055640,627273,3249,-1624461,963364,-840,130,0
603872,-1074491,473217,2598,-1629907,717234,-1,130,0
-525220,78652,446566,-2,225811,1288257,627,130,0
-1344,294,1050,0,3396,12138,0,124,1
840481,174856,-1014689,648,261840,-1526847,626,130,0
-1086191,563571,524569,1949,847107,786360,1255,130,0
-634424,973086,-339963,-1301,1609797,-561806,1046,130,0
-72153,139105,-66303,649,1633468,-783219,1256,130,0
353613,-208008,-145606,-1,-949959,-675759,-210,130,0
-91,139,-47,1,16060,-5452,0,124,1
505,-626,121,0,-1186,229,0,124,1
0,0,0,0,0,0,0,124,1
-980887,367263,615573,1949,603281,1013428,1046,130,0
141313,-239099,97786,0,-309422,126546,-1,124,1
-213208,-811881,1029638,4549,-1224787,1548631,208,130,0
892483,75402,-964637,3248,113743,-1467357,836,130,0
30000,30000,30000,90000,60000,60000,180000,124,1
174,378,-553,-1,10929,-15977,-1,124,1
49401,584371,-633124,648,1356335,-1466309,1255,130,0
-118955,122854,-1951,1948,1436773,-44618,1256,130,0
-335413,-226859,563571,1299,-655650,1623413,418,130,0
977636,-80604,-895734,1298,-123380,-1348376,208,130,0
0,0,0,0,0,0,0,124,1
332,-562,230,0,-16244,6643,-1,124,1
-113755,-232709,349063,2599,-1072501,1603303,-212,130,0
0,0,0,0,0,0,0,124,1
155,-637,482,0,-1206,912,-1,124,1
731277,298361,-1029639,-1,458116,-1586337,417,130,0
-496619,-588273,1087490,2598,-885651,1631373,-1,130,0
898983,-962687,65652,1948,-1460863,97195,-1,130,0
0,0,0,0,0,0,0,124,1
705926,-393915,-312012,-1,-907855,-722053,-420,130,0
969186,-915885,-51352,1949,-1374351,-78134,-630,130,0
-564872,323712,240509,-651,935505,692516,1046,130,0
293811,-566822,274960,1949,-1633678,791387,-421,130,0
-68756,20082,48674,0,32132,77878,-1,124,1
-4576,-591,5167,0,-1707,14922,1,124,1
335412,-1064090,729977,1299,-1597439,1095542,-420,130,0
1083590,-472568,-611673,-651,-710951,-917910,-2,130,0
217108,-1019239,806030,3899,-1549260,1224158,-210,130,0
-46802,-464768,512869,1299,-1341464,1478039,-211,130,0
928234,-958136,32501,2599,-1438030,47550,-420,130,0
30000,30000,30000,90000,60000,60000,180000,124,1
237258,713076,-950986,-652,1177236,-1568951,1046,130,0
-702027,1067990,-364664,1299,1607702,-550914,1045,130,0
482318,-499869,17550,-1,-1440335,52787,-211,130,0
842431,-874283,32501,649,-1440963,54253,-211,130,0
-889884,-72153,967886,5849,-112068,1467565,1046,130,0
354913,-159906,-193058,1949,-730851,-899895,-630,130,0
155,-637,482,0,-1206,912,-1,124,1
-670826,137155,533669,-2,317141,1229185,1045,130,0
-852832,-150806,1008187,4549,-229792,1515534,627,130,0
577871,-1060190,485568,3249,-1632002,745722,-630,130,0
30000,30000,30000,90000,60000,60000,180000,124,1
0,0,0,0,0,0,0,124,1
30000,30000,30000,90000,60000,60000,180000,124,1
-1064740,354913,714376,4549,531851,1071871,1046,130,0
-642,1412,-770,0,16311,-8896,0,124,1
568771,518719,-1085541,1949,778400,-1632631,627,130,0
-1056290,436166,622723,2599,670941,954985,1465,130,0
135855,406915,-543421,-651,1179121,-1568323,836,130,0
0,-575,575,0,-1090,1090,0,124,1
-205408,-807981,1018588,5199,-1230862,1545908,-1,130,0
-1001688,198257,807330,3899,301640,1239659,836,130,0
-955536,924334,33151,1949,1391527,46083,1255,130,0
-202808,1021838,-819031,-1,1542975,-1236099,1045,130,0
-297062,1040038,-742978,-2,1585917,-1132619,1255,130,0
107,-133,25,-1,-15397,2976,-1,124,1
-141313,239099,-97786,0,309422,-126546,1,124,1
273010,57202,-330213,-1,272733,-1530617,418,130,0
-524570,78652,446566,648,226439,1288047,836,130,0
-170957,-843082,1017288,3249,-1268148,1525799,-1,130,0
30000,30000,30000,90000,60000,60000,180000,124,1
787829,221008,-1006888,1949,338298,-1552403,836,130,0
886633,-61753,-824881,-1,-103061,-1359897,-211,130,0
52,547,-599,0,1037,-1136,-1,124,1
257409,786529,-1041990,1948,1181425,-1567275,1046,130,0
-99454,135205,-35752,-1,1579214,-426696,1256,130,0
-918,-472,1390,0,-5452,16060,0,124,1
-299662,-266510,566171,-1,-768346,1632420,-1,130,0
-52002,138455,-85154,1299,1619014,-998766,837,130,0
969186,-915235,-52002,1949,-1373932,-78972,-840,130,0
841781,-874933,35101,1949,-1442848,57395,-630,130,0
-5587,3559,2027,-1,10279,5853,-1,124,1
130654,-350364,222308,2598,-1615663,1018456,-420,130,0
558,-202,-355,1,-5853,-10279,1,124,1
68756,-20082,-48674,0,-32132,-77878,1,124,1
193707,828131,-1020539,1299,1246990,-1537111,836,130,0
299011,265859,-565522,-652,770440,-1632212,627,130,0
920434,-919135,0,1299,-1414570,-629,-630,130,0
35751,-136506,104003,3248,-1566228,1184986,-631,130,0
289910,29251,-319812,-651,142650,-1480135,207,130,0
-39002,507018,-468018,-2,1470288,-1351728,836,130,0
122204,-664325,544720,2599,-1533341,1254531,-212,130,0
558370,-358814,-200858,-1302,-1034586,-577726,-630,130,0
-229459,1031588,-802131,-2,1556172,-1209077,1046,130,0
30000,30000,30000,90000,60000,60000,180000,124,1
1019888,-185907,-831382,2599,-283627,-1250971,208,130,0
5639,-2435,-3204,0,-7032,-9251,0,124,1
-277561,701376,-420566,3249,1622784,-976353,1255,130,0
878182,-837232,-41602,-652,-1380216,-67032,-840,130,0
0,0,0,0,0,0,0,124,1
-252210,563571,-312012,-651,1630744,-900943,626,130,0
-946436,218408,729977,1949,358198,1201325,627,130,0
-8451,616223,-605823,1949,1425880,-1402839,836,130,0
-1076441,654574,425765,3898,984521,637215,1464,130,0
-132605,104653,30551,2599,1219549,332014,1046,130,0
-911335,791729,119604,-2,1307737,194809,1255,130,0
-793030,1035488,-241160,1298,1562247,-365740,1674,130,0
6429,-9733,3304,0,-27810,9441,0,124,1
-63053,-77353,143655,3249,-888374,1630954,-211,130,0
-642875,1049789,-405616,1298,1620271,-627581,1046,130,0
-328913,51351,278860,1298,241312,1278411,627,130,0
-430,533,-103,0,15397,-2976,1,124,1
-297712,312011,-13001,1298,1448713,-69964,1047,130,0
-60290,62141,-1850,1,99426,-2961,0,124,1
-42252,-95554,139755,1949,-1090306,1598276,-630,130,0
-430,-103,533,0,-2976,15397,1,124,1
-391315,1070590,-678626,649,1614615,-1023065,1255,130,0
-481019,497268,-16251,-2,1439286,-49646,1255,130,0
998437,-193708,-804731,-2,-299756,-1240288,-1,130,0
30000,30000,30000,90000,60000,60000,180000,124,1
-127405,348413,-218409,2599,1615662,-1017828,627,130,0
-1409,801,608,0,9251,7032,0,124,1
-549921,162506,389364,1949,470056,1119840,417,130,0
-427717,1053039,-624674,648,1624460,-964203,1465,130,0
1051739,-765079,-283411,3249,-1151472,-427953,-630,130,0
-69840,25340,44499,-1,40544,71199,-1,124,1
-1019889,192407,832031,4549,288024,1248666,1045,130,0
-928235,-21451,955535,5849,-36239,1432374,418,130,0
669525,-137806,-531070,649,-317142,-1228767,208,130,0
312011,-1056940,747528,2599,-1589270,1122354,-630,130,0
135855,406265,-543421,-1301,1178074,-1568532,836,130,0
990637,-827482,-161857,1298,-1273594,-249064,-211,130,0
-118955,123504,-1951,2598,1437820,-46713,1255,130,0
1748,3785,-5533,0,10929,-15977,-1,124,1
-738,-674,1413,1,-7793,16328,1,124,1
724127,325012,-1048490,649,493517,-1594716,627,130,0
239858,710476,-951636,-1302,1173256,-1570627,1046,130,0
-790430,-215159,1010137,4548,-333272,1551564,627,130,0
-61753,639623,-577222,648,1482228,-1335808,1464,130,0
669525,-1075141,408215,2599,-1618177,613964,-211,130,0
101403,-137806,39001,2598,-1579844,429000,-421,130,0
-204988,211281,-6293,0,273423,-8144,0,124,1
237908,712426,-950986,-652,1176189,-1569579,628,130,0
126754,-120255,-5201,1298,-1373303,-80019,-839,130,0
707226,-347114,-358814,1298,-801024,-832235,-420,130,0
-204988,-6293,211281,0,-8144,273423,0,124,1
-88404,-893134,984786,3248,-1342720,1477410,-1,130,0
49401,462167,-511570,-2,1338949,-1479716,836,130,0
-656,238,418,0,451,792,0,124,1
512219,-990638,479067,648,-1633678,792016,-420,130,0
739727,319811,-1056290,3248,477388,-1590946,627,130,0
0,0,0,0,0,0,0,124,1
-702027,1067990,-363364,2599,1607074,-549238,836,130,0
-522,448,73,-1,12958,2132,0,124,1
0,-4898,4898,0,-14145,14145,0,124,1
-911985,965286,-51352,1949,1453530,-80019,1464,130,0
-1004938,177456,833331,5849,267915,1261863,1255,130,0
65328,-9229,-56098,1,-14767,-89757,1,124,1
-52,599,-547,0,1136,-1037,1,124,1
43,94,-138,-1,10929,-15977,-1,124,1
-809281,1029638,-220359,-2,1552192,-333690,1256,130,0
-433567,-98154,532369,648,-283836,1535225,627,130,0
-542121,662374,-118305,1948,1533968,-279018,1255,130,0
136505,-990638,859332,5199,-1505062,1303339,208,130,0
1007537,-178107,-826831,2599,-272106,-1258512,208,130,0
-123505,993237,-869733,-1,1498777,-1311928,1256,130,0
30000,30000,30000,90000,60000,60000,180000,124,1
0,0,0,0,0,0,0,124,1
-311362,298361,14300,1299,1384823,58652,1046,130,0
-139756,78652,63052,1948,925869,702990,1256,130,0
237456,-86157,-151298,1,-111497,-195798,1,124,1
-42252,136505,-93604,649,1597019,-1097218,1046,130,0
530419,136505,-668876,-1952,319236,-1546537,208,130,0
605172,-1074491,472567,3248,-1629907,716187,-210,130,0
-1396,506,889,-1,5853,10279,-1,124,1
-223609,-784580,1011437,3248,-1210334,1555125,-420,130,0
-20801,130654,-108555,1298,1524542,-1270662,1046,130,0
107,25,-133,-1,2976,-15397,-1,124,1
0,0,0,0,0,0,0,124,1
825530,-991938,169006,2598,-1526428,258489,-420,130,0
-483619,-11051,497268,2598,-33935,1431326,627,130,0
622723,-1083591,464767,3899,-1628232,696496,-211,130,0
-136506,40301,99453,3248,465867,1122773,418,130,0
-506369,34451,472567,649,98661,1362829,627,130,0
-50000,-18301,68301,0,-29282,109282,0,124,1
-99,136,-36,1,15777,-4227,1,124,1
-845682,994537,-146906,1949,1514696,-226022,1673,130,0
9899,-4949,-4949,1,-14142,-14142,0,124,1
758578,170306,-929535,-651,279646,-1532922,836,130,0
1084240,-488819,-594773,648,-736716,-894030,-2,130,0
30000,30000,30000,90000,60000,60000,180000,124,1
102053,35101,-134556,2598,416641,-1575864,-2,130,0
30000,30000,30000,90000,60000,60000,180000,124,1
-840482,-172907,1017938,4549,-262470,1527265,208,130,0
-729328,-299662,1033538,4548,-464401,1588221,417,130,0
-92003,-146356,238359,0,-189402,308465,0,124,1
-1084891,619473,467367,1949,929220,699010,627,130,0
-524570,-463468,989987,1949,-767927,1632420,-1,130,0
-218409,-809281,1030288,2598,-1220179,1550726,208,130,0
9899,-4949,-4949,1,-14142,-14142,0,124,1
-430967,1053039,-622074,-2,1625298,-959385,1256,130,0
-1073191,572021,506368,5198,868473,764365,1255,130,0
609722,-617524,9750,1948,-1424834,19899,-840,130,0
-1414,707,707,0,8167,8167,0,124,1
963336,-288611,-676026,-1301,-476132,-1115024,-421,130,0
-122205,993237,-869733,1299,1498358,-1312347,1256,130,0
222115,-190735,-31380,0,-246833,-40610,0,124,1
1077090,-654575,-421216,1299,-986617,-634284,-421,130,0
880132,-995838,118954,3248,-1495635,178051,-420,130,0
-1951,-489469,492068,648,-1411009,1418549,-420,130,0
-559021,205407,354913,1299,592179,1022436,627,130,0
-482,497,-14,1,14354,-427,0,124,1
-7527,-1804,9331,0,-5154,26661,0,124,1
-103,-516,620,1,-978,1175,1,124,1
0,0,0,0,0,0,0,124,1
-1548,9241,-7693,0,26405,-21981,0,124,1
484918,11050,-496619,-651,33725,-1431118,-211,130,0
-338013,79302,260009,1298,369719,1192946,417,130,0
-376365,704626,-326963,1298,1632630,-759339,1046,130,0
-128705,347763,-218409,649,1616081,-1014686,417,130,0
-9414,2058,7356,0,5880,21019,0,124,1
-432917,-99454,533019,648,-286769,1536063,417,130,0
-155,637,-482,0,1206,-912,1,124,1
-128705,111154,19500,1949,1301034,205702,1465,130,0
-363364,-342563,708526,2599,-793902,1633049,208,130,0
-1076441,411465,667575,2599,617944,1000651,837,130,0
-167707,1012737,-845032,-2,1523913,-1271500,836,130,0
-221,1320,-1099,0,15249,-12694,0,124,1
-9145,7853,1292,0,22439,3691,-1,124,1
1053689,-340613,-711777,1299,-519074,-1081717,-211,130,0
191107,-999088,810580,2599,-1537949,1245943,-421,130,0
-113105,-14951,131304,3248,-168417,1491026,417,130,0
-733228,1044589,-310062,1299,1591364,-474666,1255,130,0
260659,437466,-698127,-2,1013219,-1615873,208,130,0
-21850,-47314,69165,1,-75703,110664,0,124,1
1043939,-778730,-263260,1949,-1174304,-396323,-420,130,0
646,-188,-457,1,-357,-866,0,124,1
52,-599,547,0,-1136,1037,-1,124,1
-874283,956185,-81254,648,1474687,-127988,1046,130,0
504,-29,-474,1,-854,-13698,1,124,1
-126,118,7,-1,13698,854,-1,124,1
437,-1383,946,0,-15977,10929,-1,124,1
-375715,704626,-327613,1298,1632839,-761434,1255,130,0
431,-653,221,-1,-1237,420,0,124,1
-460218,-55903,516119,-2,-162970,1489141,627,130,0
48751,462167,-510920,-2,1341463,-1477621,1046,130,0
0,0,0,0,0,0,0,124,1
-297062,312661,-14301,1298,1450807,-74573,1045,130,0
-106604,131954,-24051,1299,1540462,-298499,1046,130,0
437,946,-1383,0,10929,-15977,-1,124,1
298361,267160,-565522,-1,772116,-1632212,627,130,0
-1019239,769628,249609,-2,1185196,381659,1256,130,0
1073190,-570722,-501819,649,-867846,-764366,208,130,0
-139106,50701,90353,1948,588827,1025159,627,130,0
-1260,74,1186,0,854,13698,-1,124,1
541,860,-1402,-1,9943,-16194,-1,124,1
-791730,1022488,-230109,649,1558057,-352962,1255,130,0
-980887,362713,618173,-1,597206,1018246,627,130,0
-886634,60452,828131,1949,97823,1363248,417,130,0
-114,-14,129,1,-1707,14922,1,124,1
-635724,971786,-337363,-1301,1609169,-558036,1255,130,0
-11,-116,127,0,-13461,14742,0,124,1
207357,807980,-1015339,-2,1231280,-1544652,1674,130,0
-377015,-689676,1071890,5199,-1040661,1610635,-211,130,0
-1066040,639623,431616,5199,971743,651669,836,130,0
41562,-70323,28760,-1,-112517,46016,-1,124,1
696176,-245060,-451767,-651,-564739,-1044850,-630,130,0
-917835,137155,781329,649,226649,1287628,836,130,0
156655,-352964,198907,2598,-1629698,914138,-211,130,0
-793030,1036138,-241810,1298,1562456,-366997,1255,130,0
-1072541,570721,507018,5198,866588,766460,1255,130,0
532369,134555,-668226,-1302,315046,-1544862,836,130,0
46801,585671,-631824,648,1359896,-1463586,1255,130,0
568771,518069,-1085541,1299,777981,-1632212,1045,130,0
291210,-1050440,762478,3248,-1581100,1146653,-211,130,0
-633774,587622,46801,649,1360106,104107,1255,130,0
205,444,-650,-1,842,-1231,-1,124,1
-537,-69,607,1,-131,1149,0,124,1
432266,99453,-531720,-1,288653,-1536273,208,130,0
-144956,1003637,-858033,648,1511764,-1291819,1046,130,0
-663675,1073190,-407566,1949,1618385,-616269,1046,130,0
313961,390664,-704627,-2,905131,-1629489,1045,130,0
36946,-70686,33740,0,-113098,53984,-1,124,1
-98804,135205,-36402,-1,1579214,-426487,1255,130,0
-103,-516,620,1,-978,1175,1,124,1
73,-141,67,-1,-16328,7793,-1,124,1
-27059,-43045,70105,1,-68873,112169,1,124,1
130,-18,-112,0,-2132,-12958,0,124,1
-239209,-711777,952285,1299,-1175771,1569997,-212,130,0
-135856,-408216,544070,-2,-1179541,1568531,208,130,0
1042639,-781330,-260660,649,-1177237,-392343,-630,130,0
-65328,9229,56098,-1,14767,89757,-1,124,1
128054,-542121,413415,-652,-1562457,1194413,-210,130,0
-1009488,823580,189157,3249,1252437,283207,1466,130,0
662,-286,-376,0,-541,-712,1,124,1
30000,30000,30000,90000,60000,60000,180000,124,1
107,-133,25,-1,-15397,2976,-1,124,1
-72153,139105,-65653,1299,1633468,-779239,1256,130,0
30000,30000,30000,90000,60000,60000,180000,124,1
1396,-889,-506,1,-10279,-5853,1,124,1
295,269,-565,-1,7793,-16328,-1,124,1
215808,812530,-1027689,649,1223739,-1549051,627,130,0
507669,-1060840,556420,3249,-1633259,855067,-420,130,0
-668226,-377665,1049139,3248,-584010,1612730,-210,130,0
724127,339962,-1062140,1949,509437,-1598277,417,130,0
-144956,917834,-775480,-2602,1519095,-1280298,626,130,0
-796930,906783,-110505,-652,1498148,-184336,1046,130,0
256109,-565522,310711,1298,-1630955,897799,-2,130,0
-260660,-437467,702026,3899,-1011544,1616291,-211,130,0
48101,585021,-633124,-2,1356545,-1466100,837,130,0
0,0,0,0,0,0,0,124,1
110504,-967887,859982,2599,-1491446,1323029,-420,130,0
446566,621423,-1068641,-652,945978,-1625509,836,130,0
30000,30000,30000,90000,60000,60000,180000,124,1
-221,1320,-1099,0,15249,-12694,0,124,1
891833,76052,-964637,3248,114162,-1467566,1046,130,0
-541471,663024,-118955,2598,1534177,-279856,1255,130,0
-214212,12582,201630,0,16283,260933,0,124,1
-893134,-86454,982836,3248,-131759,1475735,627,130,0
939935,-741678,-198258,-1,-1223740,-325102,-211,130,0
-1062790,722177,343212,2599,1086115,514255,1255,130,0
574621,-987387,412765,-1,-1626765,681833,-420,130,0
-344513,105953,240509,1949,493308,1101826,627,130,0
298361,-966587,670175,1949,-1594716,1103711,-839,130,0
9868,-4261,-5607,0,-12176,-16020,1,124,1
-8820,518,8302,0,1480,23721,0,124,1
399114,-547971,149505,648,-1579844,429419,-211,130,0
141055,837881,-979587,-651,1292865,-1510718,1045,130,0
-217759,-341913,562271,2599,-988083,1620480,-2,130,0
120,-124,3,-1,-14354,427,0,124,1
-295,-269,565,1,-7793,16328,1,124,1
-457,-59,516,0,-1707,14922,1,124,1
-240416,120208,120208,0,155563,155563,0,124,1
99,-136,36,-1,-15777,4227,-1,124,1
-642,1412,-770,0,16311,-8896,0,124,1
4576,-5167,591,0,-14922,1707,-1,124,1
-63053,-77353,142355,1949,-887536,1631163,208,130,0
-947736,20150,932134,4548,26812,1400953,627,130,0
267160,-337363,71502,1299,-1548842,323635,-421,130,0
-592,34,557,-1,65,1055,-1,124,1
30000,30000,30000,90000,60000,60000,180000,124,1
313311,391314,-704627,-2,905759,-1629698,417,130,0
1144,147,-1291,0,1707,-14922,-1,124,1
-333463,265859,69552,1948,1232118,313371,1256,130,0
-2310,-7180,9491,1,-20516,27119,1,124,1
-527820,1071890,-543421,649,1633886,-828046,1464,130,0
639623,-1082941,446566,3248,-1625509,668846,-421,130,0
-576572,1057589,-479718,1299,1632001,-742162,1465,130,0
-536921,421865,114404,-652,1222063,328243,836,130,0
204757,-353614,152105,3248,-1628022,693773,-420,130,0
-1012738,165756,849581,2599,247387,1274850,1046,130,0
5500,-3893,-1606,1,-11243,-4639,0,124,1
-596723,1080340,-484269,-652,1630744,-731060,1046,130,0
-689676,479067,213207,2598,1107482,486186,837,130,0
30000,30000,30000,90000,60000,60000,180000,124,1
946435,-936036,-6501,3898,-1409123,-11103,-211,130,0
-531720,-549921,1086190,4549,-830979,1633468,418,130,0
-469,-172,642,1,-325,1215,1,124,1
1005587,-176807,-828782,-2,-269592,-1260188,208,130,0
-837882,-159256,1003637,6499,-244246,1520771,836,130,0
-639624,-440067,1083590,3899,-662982,1624460,207,130,0
-250260,1039388,-789780,-652,1564970,-1188549,836,130,0
1004937,-865183,-139106,648,-1298522,-209473,-211,130,0
224908,-947736,724127,1299,-1562876,1193575,-630,130,0
139,-50,-88,1,-5853,-10279,1,124,1
-504,29,474,-1,854,13698,-1,124,1
-145606,918484,-774830,-1952,1519514,-1279041,836,130,0
1039388,-248310,-789780,1298,-375376,-1189177,-421,130,0
3059,6624,-9683,0,18925,-27666,-1,124,1
-341263,246359,97503,2599,1143511,438426,627,130,0
-286011,-751429,1042639,5199,-1144350,1581937,417,130,0
783279,261309,-1041990,2598,390038,-1567904,836,130,0
22,109,-132,-1,12694,-15249,0,124,1
-170000,-62224,232224,0,-80525,300525,0,124,1
-154706,351013,-195658,649,1629906,-912254,626,130,0
-302912,-728028,1033538,2598,-1123612,1588640,-421,130,0
5172,-9896,4723,-1,-28274,13496,0,124,1
-1075,1333,-257,1,15397,-2976,1,124,1
-69840,44499,25340,-1,71199,40544,-1,124,1
-988688,435516,554470,1298,717862,912253,1045,130,0
-409516,-294462,705926,1948,-682672,1626136,-420,130,0
-297712,312661,-12351,2598,1447875,-67870,1046,130,0
-131955,104653,30551,3249,1219340,332223,1255,130,0
-370514,978286,-608423,-651,1618176,-1004841,836,130,0
614,-86,-527,1,-164,-998,0,124,1
40951,-509620,468017,-652,-1469870,1352355,-211,130,0
-191108,-829432,1022488,1948,-1248458,1536272,-2,130,0
55252,85153,-138456,1949,994157,-1619015,836,130,0
-313962,-390665,706576,1949,-905760,1629906,-2,130,0
-495319,-589573,1088140,3248,-887327,1631373,208,130,0
134,-29,-105,0,-3396,-12138,0,124,1
-917185,917834,-651,-2,1416454,-3143,1046,130,0
569421,-1088791,523269,3899,-1633469,783846,-212,130,0
-114,-14,129,1,-1707,14922,1,124,1
880782,111804,-991938,648,166111,-1489980,417,130,0
-64,-77,141,0,-8896,16311,0,124,1
372463,-981537,609722,648,-1617758,1006306,-421,130,0
-280811,324362,-41602,1949,1505061,-201304,1255,130,0
-52,-547,599,0,-1037,1136,1,124,1
533019,527169,-1059540,648,811287,-1633050,417,130,0
668875,-139756,-529770,-651,-319865,-1226882,208,130,0
-343863,105303,240509,1949,489747,1104758,627,130,0
884033,-58503,-826831,-1301,-98034,-1362830,-211,130,0
226858,-350364,126754,3248,-1611683,573536,-210,130,0
0,0,0,0,0,0,0,124,1
0,0,0,0,0,0,0,124,1
-204758,1023138,-817731,649,1544023,-1234004,1046,130,0
538220,-423816,-114405,-1,-1220179,-330339,-211,130,0
30000,30000,30000,90000,60000,60000,180000,124,1
30000,30000,30000,90000,60000,60000,180000,124,1
-378965,-688376,1071240,3899,-1039194,1611054,-210,130,0
578521,-644175,67602,1948,-1485371,153124,-420,130,0
-202158,351013,-147556,1299,1627602,-688537,1046,130,0
-559671,206707,353613,649,595321,1019713,628,130,0
-685126,1070590,-384815,649,1612939,-580449,1046,130,0
29251,-931485,906133,3899,-1435726,1392574,-211,130,0
932784,-31202,-900934,648,-49436,-1388595,417,130,0
-205,650,-444,1,1231,-842,1,124,1
-71503,139755,-66303,1949,1633468,-785942,1046,130,0
139105,-98804,-39002,1299,-1125707,-462307,-421,130,0
4576,591,-5167,0,1707,-14922,-1,124,1
-1084891,490118,598022,3249,735877,895286,1046,130,0
127404,-120255,-6501,648,-1370999,-84209,-630,130,0
217108,812530,-1027039,2599,1223111,-1549051,627,130,0
503768,-477118,-25351,1299,-1375608,-75201,-421,130,0
108554,-966587,861282,3249,-1490399,1324914,-212,130,0
-643525,-435517,1082940,3898,-656697,1623622,418,130,0
280810,-703327,425115,2598,-1622576,978446,-630,130,0
531069,136505,-668226,-652,317979,-1545909,627,130,0
430316,-1055640,627273,1949,-1624252,963993,-421,130,0
239675,-103501,-136173,1,-133943,-176224,0,124,1
-8440,-259,8699,0,-740,24856,0,124,1
-863233,1001687,-137156,1298,1508203,-209054,1465,130,0
-189808,-164457,355563,1298,-754312,1631582,-212,130,0
-114,-14,129,1,-1707,14922,1,124,1
0,0,0,0,0,0,0,124,1
-60453,-272361,334112,1298,-1251809,1534806,-1,130,0
-565522,247659,317861,-2,714092,915395,627,130,0
84503,810580,-896384,-1301,1339787,-1479297,1046,130,0
83,57,-140,0,6643,-16244,-1,124,1
566821,-287961,-278861,-1,-829093,-804166,-420,130,0
299661,-967887,668875,649,-1595135,1102873,-630,130,0
-531720,-549921,1086190,4549,-830769,1633468,209,130,0
354263,-159256,-194358,649,-726661,-903456,-211,130,0
55252,85153,-138456,1949,990805,-1619853,207,130,0
334112,226858,-562922,-1952,658582,-1623414,418,130,0
-401066,-144956,547320,1298,-415804,1575863,208,130,0
-549921,391314,158605,-2,1131361,454974,417,130,0
-117005,661074,-543421,648,1531664,-1257884,1046,130,0
431616,98803,-531720,-1301,288234,-1536273,-1,130,0
-958136,873632,85153,649,1346699,128616,1674,130,0
256,308,-564,0,8896,-16311,0,124,1
30000,30000,30000,90000,60000,60000,180000,124,1
345812,-107905,-237259,648,-491004,-1103712,-629,130,0
408865,295111,-702677,1299,684347,-1625927,1047,130,0
51351,-328913,280160,2598,-1515954,1285324,-420,130,0
-575922,1057589,-481019,648,1631792,-742372,1255,130,0
-1748,5533,-3785,0,15977,-10929,1,124,1
30000,30000,30000,90000,60000,60000,180000,124,1
531069,135855,-668226,-1302,316932,-1545490,627,130,0
0,0,0,0,0,0,0,124,1
4576,591,-5167,0,1707,-14922,-1,124,1
0,0,0,0,0,0,0,124,1
109146,130940,-240086,0,169451,-310700,-1,124,1
958785,-874933,-81904,1948,-1346281,-128198,-420,130,0
636373,-589573,-44852,1948,-1358640,-106413,-420,130,0
30000,30000,30000,90000,60000,60000,180000,124,1
9777,-3547,-6229,1,-10136,-17799,1,124,1
467367,-694877,230108,2598,-1603304,529337,-420,130,0
-137156,40951,99453,3248,467961,1121307,627,130,0
-1032889,811880,222308,1299,1220178,331176,1256,130,0
330862,-54603,-275611,648,-244036,-1276527,-211,130,0
43,-138,94,-1,-15977,10929,-1,124,1
156655,-352964,200207,3898,-1629698,915605,-420,130,0
42251,-509620,467367,-2,-1470918,1351308,-2,130,0
550570,-165107,-388065,-2602,-470895,-1119213,-630,130,0
254,404,-658,0,766,-1247,0,124,1
445916,623373,-1067991,1298,948911,-1625090,1255,130,0
45922,-69526,23603,-1,-111242,37765,-1,124,1
-539521,120254,419265,-2,347515,1208657,837,130,0
-351664,204107,148855,1298,947026,679529,1046,130,0
-311362,299011,13650,1299,1386918,54672,1046,130,0
-536921,421865,115704,648,1220597,330757,1256,130,0
126104,-995188,871682,2598,-1499197,1311927,208,130,0
174,-553,378,-1,-15977,10929,-1,124,1
-893134,-87104,983486,3248,-133854,1476572,417,130,0
30000,30000,30000,90000,60000,60000,180000,124,1
21850,47314,-69165,-1,75703,-110664,0,124,1
-791080,1022488,-230759,649,1558476,-353590,1674,130,0
300961,-315912,16250,1299,-1448504,69754,-630,130,0
-139756,59802,81253,1299,703618,924821,626,130,0
-166407,1011437,-845682,-652,1523075,-1272757,1254,130,0
842431,-873633,33151,1949,-1441173,54462,-421,130,0
-167057,1012087,-845682,-652,1523704,-1271919,836,130,0
796279,-1026389,232708,2598,-1558058,352961,-211,130,0
-3673,5562,-1888,1,16060,-5452,0,124,1
-982187,889883,95553,3249,1339368,140975,1465,130,0
991287,-824231,-165757,1299,-1270243,-254929,-630,130,0
46151,585671,-632474,-652,1360106,-1463167,1465,130,0
-140406,70202,71502,1298,823227,810449,1045,130,0
9868,-4261,-5607,0,-12176,-16020,1,124,1
-928885,-21451,955535,5199,-35401,1431955,628,130,0
91,47,-139,-1,5452,-16060,0,124,1
-170307,551220,-380915,-2,1596391,-1099523,836,130,0
-328263,560971,-232709,-1,1626136,-674293,837,130,0
332,230,-562,0,6643,-16244,-1,124,1
-844382,995837,-148856,2599,1515953,-229792,1465,130,0
-103,620,-516,1,1175,-978,1,124,1
289260,750778,-1038739,1299,1142673,-1581938,627,130,0
9777,-3547,-6229,1,-10136,-17799,1,124,1
-709827,-355564,1071240,5849,-537298,1604560,417,130,0
109204,-133906,26650,1948,-1540672,299336,-420,130,0
949035,-16251,-928885,3899,-28489,-1399906,208,130,0
-1058890,315261,746877,3248,470685,1119422,837,130,0
314611,-300962,-11051,2598,-1384196,-59700,-839,130,0
5040,-296,-4744,0,-854,-13698,1,124,1
-237456,86157,151298,-1,111497,195798,-1,124,1
0,0,0,0,0,0,0,124,1
-63003,3700,59302,-1,5921,94884,0,124,1
537,-420,-117,0,-12138,-3396,0,124,1
80603,-978287,900933,3249,-1470918,1351517,-2,130,0
167056,185906,-351664,1298,865750,-1632002,836,130,0
284710,-327613,43551,648,-1502967,196275,-421,130,0
46151,-138456,96853,4548,-1597858,1093447,-839,130,0
214508,812530,-1027689,-651,1223320,-1548842,626,130,0
566171,83203,-648075,1299,194181,-1501082,627,130,0
-404316,-142356,546670,-2,-410567,1574396,208,130,0
451116,243759,-695527,-652,564319,-1609170,417,130,0
-125617,240333,-114716,0,311020,-148456,1,124,1
313311,657174,-969187,1298,1083602,-1599953,208,130,0
-216,-344,560,0,-9943,16194,1,124,1
-633774,585671,48751,648,1357801,107878,836,130,0
377664,-707877,332812,2599,-1632840,764994,-420,130,0
455667,601272,-1056290,649,926288,-1627813,836,130,0
1085540,-561622,-522620,1298,-846480,-786570,-211,130,0
-496619,-587623,1087490,3248,-884813,1631582,-2,130,0
406915,295761,-703327,-651,685813,-1626137,627,130,0
-119605,992587,-871683,1299,1496682,-1315280,1046,130,0
68756,-48674,-20082,0,-77878,-32132,1,124,1
-53302,-87104,141055,649,-993529,1619433,-420,130,0
-224259,690975,-465418,1298,1601837,-1079204,836,130,0
-459568,-596723,1059539,3248,-920423,1628859,-1,130,0
-590223,-392615,984136,1298,-650413,1622784,-2,130,0
642,770,-1412,0,8896,-16311,0,124,1
-87754,-893784,984136,2598,-1343768,1476572,-2,130,0
986086,-436167,-552521,-2602,-719539,-910369,-630,130,0
1077740,-433567,-642875,1298,-655441,-967974,-2,130,0
1053689,-341913,-710477,1299,-520959,-1080042,-2,130,0
-4301,-1030,5332,1,-2976,15397,1,124,1
-1046540,273010,777429,3899,407843,1166134,837,130,0
52,547,-599,0,1037,-1136,-1,124,1
4823,148,-4971,0,427,-14354,0,124,1
30000,30000,30000,90000,60000,60000,180000,124,1
30000,30000,30000,90000,60000,60000,180000,124,1
-939286,919784,21450,1948,1400115,29954,1674,130,0
191757,828781,-1020539,-1,1248038,-1536692,1046,130,0
18862,-216996,198133,-1,-280818,256407,-1,124,1
-120,124,-3,1,14354,-427,0,124,1
-2310,-7180,9491,1,-20516,27119,1,124,1
4576,-5167,591,0,-14922,1707,-1,124,1
-895734,959435,-61753,1948,1461281,-97196,1465,130,0
1038738,-246360,-791080,1298,-372233,-1191062,-210,130,0
-652625,-319162,971786,-1,-528291,1602675,-2,130,0
30000,30000,30000,90000,60000,60000,180000,124,1
132,-542,410,0,-15661,11848,0,124,1
279510,768978,-1047190,1298,1157755,-1576701,1256,130,0
-43,-94,138,1,-10929,15977,1,124,1
9145,-1292,-7853,0,-3691,-22439,1,124,1
-134,29,105,0,3396,12138,0,124,1
92003,-238359,146356,0,-308465,189402,0,124,1
-214212,201630,12582,0,260933,16283,0,124,1
64352,-642225,579821,1948,-1481810,1336645,-210,130,0
-234009,-112455,349063,2599,-518445,1600371,-210,130,0
93603,-141056,49401,1948,-1606865,547771,-420,130,0
-977637,83203,899633,5199,123588,1348585,417,130,0
399114,-548621,150155,648,-1580262,431304,-210,130,0
531719,135205,-668226,-1302,316094,-1545281,627,130,0
10400,850231,-861283,-652,1406399,-1422948,627,130,0
239858,711126,-952286,-1302,1174094,-1570627,627,130,0
-889234,-72153,968536,7149,-112487,1467775,837,130,0
1074490,-570072,-503119,1299,-866380,-765833,-2,130,0
123504,860632,-984137,-1,1311717,-1498359,1464,130,0
-8008,9043,-1034,1,25838,-2956,0,124,1
-224909,-784580,1011437,1948,-1209705,1555334,-211,130,0
-364014,555770,-191108,648,1608331,-554475,836,130,0
179406,374414,-554471,-651,1084021,-1599743,628,130,0
-765079,1049789,-283411,1299,1579843,-429001,1046,130,0
0,0,0,0,0,0,0,124,1
-70492,30441,40050,-1,48706,64081,-1,124,1
1054339,-432267,-621424,648,-668009,-956662,-211,130,0
-565,282,282,-1,8167,8167,0,124,1
-107255,965936,-859333,-652,1490398,-1324077,1465,130,0
-502469,1059539,-555771,1299,1633468,-857791,1465,130,0
-447217,1077740,-629874,649,1626136,-949540,1256,130,0
-544071,1083590,-538871,648,1633886,-812336,1254,130,0
-551221,165106,387414,1299,475712,1115232,208,130,0
110,1165,-1276,-1,13461,-14742,0,124,1
-1375,401,973,-1,4639,11243,0,124,1
-48752,951635,-903534,-651,1450388,-1375817,836,130,0
997137,-876233,-118955,1949,-1316117,-180147,-211,130,0
10400,-617524,609072,1948,-1426091,1402838,-421,130,0
45922,23603,-69526,-1,37765,-111242,-1,124,1
-550,389,160,-1,11243,4639,0,124,1
-81904,979586,-897034,648,1472592,-1348586,836,130,0
368563,185256,-555771,-1952,538344,-1604561,-211,130,0
-237456,86157,151298,-1,111497,195798,-1,124,1
537,-420,-117,0,-12138,-3396,0,124,1
-962037,686425,275610,-2,1133875,452042,837,130,0
-574622,1057589,-482969,-2,1632211,-745723,1675,130,0
-655875,-418616,1079690,5199,-631351,1620271,-1,130,0
1058889,-579822,-477768,1299,-894030,-736716,-211,130,0
1036788,-710477,-326963,-652,-1093867,-503782,-630,130,0
-74753,335412,-258710,1949,1557638,-1205097,1045,130,0
-865183,1000387,-133906,1298,1506108,-204027,1255,130,0
0,1224,-1224,0,14145,-14145,0,124,1
-854132,-148856,1007537,4549,-226440,1514278,837,130,0
-566172,286010,280810,648,825322,808564,1046,130,0
-456968,-620124,1081640,4548,-936553,1627393,418,130,0
-938636,920434,20150,1948,1401162,27650,1465,130,0
-90354,-47452,140405,2599,-544839,1605817,-2,130,0
155,482,-637,0,912,-1206,-1,124,1
136505,-106604,-28602,1299,-1215152,-338089,-630,130,0
-57206,-7391,64597,0,-11826,103355,0,124,1
0,0,0,0,0,0,0,124,1
215808,812530,-1027689,649,1223739,-1548632,1046,130,0
536920,-425116,-112455,-651,-1223740,-325521,-630,130,0
-48752,-463468,513519,1299,-1338321,1480552,-420,130,0
-705927,1036788,-329563,1298,1599323,-509648,1045,130,0
-364014,-690326,1060189,5849,-1052182,1608331,-211,130,0
-7000,-2562,9562,0,-7320,27320,0,124,1
-705927,394564,312661,1298,912044,718072,1256,130,0
641574,440716,-1079691,2599,660257,-1623623,627,130,0
-222959,347763,-122205,2599,1612101,-575841,627,130,0
-443,-4661,5105,1,-13461,14742,0,124,1
30000,30000,30000,90000,60000,60000,180000,124,1
-949036,23400,930184,4548,32468,1398230,1046,130,0
658474,417965,-1075791,648,628208,-1619643,418,130,0
30000,30000,30000,90000,60000,60000,180000,124,1
30000,30000,30000,90000,60000,60000,180000,124,1
1060189,-507019,-552521,649,-782172,-850460,-212,130,0
757278,172256,-930185,-651,282369,-1533969,627,130,0
-336713,-224909,562921,1299,-651251,1622784,-2,130,0
-102054,342562,-239209,1299,1592411,-1112719,837,130,0
-363364,555770,-191758,648,1608959,-557407,1046,130,0
-854783,-147556,1006887,4548,-224136,1513649,1046,130,0
-154706,351013,-195658,649,1629906,-912673,836,130,0
148855,-921735,774829,1949,-1520982,1276736,-1,130,0
4000,1464,-5464,0,4227,-15777,0,124,1
-209308,-480368,690975,1299,-1108949,1593039,-421,130,0
379614,-1061490,685775,3899,-1611264,1039822,-1,130,0
-1017289,770278,248959,1948,1185824,380611,1255,130,0
2568,-5649,3080,-1,-16311,8896,0,124,1
30000,30000,30000,90000,60000,60000,180000,124,1
132604,-989338,859982,3248,-1503805,1305224,-211,130,0
-72803,-67603,143655,3249,-775887,1632420,-211,130,0
-459568,-55903,516119,648,-162551,1488931,627,130,0
221,-1320,1099,0,-15249,12694,0,124,1
-347,664,-317,0,1258,-600,1,124,1
-550,389,160,-1,11243,4639,0,124,1
0,0,0,0,0,0,0,124,1
239208,711776,-951636,-652,1174932,-1570208,417,130,0
769628,-1053040,285360,1948,-1579425,427114,-421,130,0
-332813,1061489,-727378,1298,1597438,-1095752,627,130,0
45501,-139756,96853,2598,-1597858,1094075,-630,130,0
937985,5200,-942536,649,5446,-1417083,208,130,0
-549921,391964,157955,-2,1132618,453298,626,130,0
-987387,568771,418615,-1,938647,689165,1047,130,0
669525,-1075141,408215,2599,-1618386,614383,-629,130,0
-1075791,685775,390664,648,1030396,582753,837,130,0
-400,-146,546,0,-4227,15777,0,124,1
996487,-876233,-117655,2599,-1317374,-177843,-211,130,0
30000,30000,30000,90000,60000,60000,180000,124,1
30000,30000,30000,90000,60000,60000,180000,124,1
239675,-136173,-103501,1,-176224,-133943,0,124,1
958135,-876883,-79953,1299,-1348586,-124637,-840,130,0
-43,138,-94,1,15977,-10929,1,124,1
594772,478417,-1071891,1298,727079,-1629698,836,130,0
-5172,-4723,9896,1,-13496,28274,0,124,1
-351014,1041339,-689026,1299,1605817,-1063912,1255,130,0
-1004938,863232,142355,649,1297683,211148,1046,130,0
-729978,1045889,-314612,1299,1592620,-480531,1255,130,0
-1051090,765078,287960,1948,1150633,429419,1465,130,0
-350364,132604,219708,1948,615221,1002955,837,130,0
-11061,-54952,66014,1,-87924,105622,0,124,1
-120,-3,124,1,-427,14354,0,124,1
267160,-337363,72152,1949,-1550098,327196,-629,130,0
-5201,-303562,310061,1298,-1401373,1427556,-421,130,0
674075,-1065390,395214,3899,-1615663,598044,-1,130,0
-457,-59,516,0,-1707,14922,1,124,1
455667,-1071891,620123,3899,-1627394,939903,-2,130,0
636373,-589573,-44852,1948,-1358221,-106832,-420,130,0
949685,-16251,-928885,4549,-27651,-1400325,-1,130,0
481668,-499869,18850,649,-1441801,55300,-630,130,0
63052,269110,-330863,1299,1250132,-1535435,627,130,0
-482,497,-14,1,14354,-427,0,124,1
55902,887283,-944486,-1301,1369322,-1456045,1046,130,0
-44,510,-466,0,14742,-13461,0,124,1
-768329,1015988,-246360,1299,1567274,-382707,1674,130,0
-5040,4744,296,0,13698,854,-1,124,1
-382865,-664325,1049139,1949,-1025579,1613777,-2,130,0
429666,-536271,107254,649,-1543395,307715,-211,130,0
380264,687725,-1068641,-652,1036680,-1611264,418,130,0
1344,-1050,-294,0,-12138,-3396,0,124,1
89703,250259,-339963,-1,1166553,-1573350,836,130,0
44851,92953,-136506,1298,1089257,-1598277,836,130,0
-590873,-477768,1075140,6499,-728128,1630535,417,130,0
943185,-213208,-730628,-651,-352753,-1204678,-421,130,0
1004287,-867133,-135206,1948,-1301664,-204446,-630,130,0
1076440,-408866,-666275,1299,-616898,-1001280,-211,130,0
-48752,-463468,512869,649,-1338950,1479924,-211,130,0
-939286,741677,196307,-1302,1225624,323216,1046,130,0
4823,-4971,148,0,-14354,427,0,124,1
-850232,-13001,865832,2599,-24090,1426508,626,130,0
-1034189,228158,809280,3249,341440,1212846,836,130,0
-1075791,653924,425115,3248,983893,637844,1256,130,0
-1017289,771578,247659,1948,1187710,378307,1465,130,0
-550,160,389,-1,4639,11243,0,124,1
143005,208007,-349064,1948,969230,-1622785,628,130,0
126,-118,-7,1,-13698,-854,1,124,1
-155,-482,637,0,-912,1206,1,124,1
-1045890,274310,776129,4549,409519,1165087,1047,130,0
11700,-128705,118304,1299,-1473222,1347747,-211,130,0
-1087491,548620,541470,2599,824065,809611,1045,130,0
-566822,-83854,651974,1298,-194601,1501500,208,130,0
-249610,1040038,-789780,648,1565179,-1188339,1045,130,0
330212,-53302,-275611,1299,-240685,-1278412,-2,130,0
-214509,1016638,-802781,-652,1549678,-1222693,1045,130,0
-563,243,320,0,7032,9251,0,124,1
-240416,120208,120208,0,155563,155563,0,124,1
-34452,-287961,324362,1949,-1328686,1487256,-420,130,0
-362714,-344513,709176,1949,-797672,1633049,209,130,0
222115,-31380,-190735,0,-40610,-246833,0,124,1
-662,286,376,0,541,712,-1,124,1
-9899,4949,4949,-1,14142,14142,0,124,1
-132605,104653,30551,2599,1217245,335575,1255,130,0
0,0,0,0,0,0,0,124,1
-106604,131954,-24701,649,1540881,-299337,1046,130,0
978936,-877533,-99454,1949,-1332247,-152287,208,130,0
529769,-1084891,559670,4548,-1633678,840823,-1,130,0
-539521,121554,417965,-2,351285,1206143,1045,130,0
124154,-993888,873632,3898,-1497521,1314441,208,130,0
84503,-980237,898333,2599,-1473431,1347747,418,130,0
228808,-694877,468017,1948,-1602467,1076689,-421,130,0
-156137,236390,-80252,1,305917,-103856,1,124,1
503768,-477768,-26001,-1,-1375398,-75620,-420,130,0
-117655,-863883,986736,5198,-1315070,1497101,-211,130,0
339312,-80604,-256760,1948,-368882,-1193576,-211,130,0
-1409,608,801,0,7032,9251,0,124,1
-646,188,457,-1,357,866,0,124,1
-217759,-341913,562271,2599,-988293,1620480,-2,130,0
494018,-1086191,595422,3249,-1631583,892982,-420,130,0
139105,-41602,-95554,1949,-469848,-1119841,-420,130,0
-156137,-80252,236390,1,-103856,305917,1,124,1
214508,-561622,348413,1299,-1617968,1004212,-211,130,0
442016,-988688,548620,1948,-1630326,904293,-420,130,0
-5639,2435,3204,0,7032,9251,0,124,1
-791730,1022488,-228159,2599,1557429,-350448,1465,130,0
-4823,4971,-148,0,14354,-427,0,124,1
-841782,872332,-31852,-1302,1441591,-54044,1256,130,0
259359,305511,-565522,-652,884393,-1631164,627,130,0
841781,-874933,33801,649,-1442010,56138,-630,130,0
-957486,922384,37051,1949,1388384,52158,1464,130,0
650674,-85804,-564872,-2,-196905,-1305434,-1,130,0
-387415,-594773,983486,1298,-982637,1621318,-2,130,0
523269,551220,-1073841,648,838519,-1632421,1465,130,0
-377015,-689026,1072540,6499,-1040661,1610635,-211,130,0
-4494,9885,-5391,0,28245,-15404,1,124,1
-828782,-192408,1025738,4548,-290958,1537320,418,130,0
74292,-235162,160869,-1,-304328,208184,-1,124,1
-643525,1050439,-404966,1948,1620271,-626952,1256,130,0
492718,-1086841,596072,1949,-1630955,894657,-211,130,0
131954,-113755,-16251,1948,-1300197,-206541,-630,130,0
-272361,-59153,334112,2598,-272524,1530826,209,130,0
-116355,661074,-543421,1298,1531454,-1258512,1465,130,0
1052389,-644825,-404966,2598,-994786,-624858,-421,130,0
-588273,-394565,984786,1948,-653346,1623203,207,130,0
348413,-228809,-120255,-651,-1049040,-559921,-630,130,0
-2310,9491,-7180,1,27119,-20516,1,124,1
-3673,-1888,5562,1,-5452,16060,0,124,1
30000,30000,30000,90000,60000,60000,180000,124,1
-311362,298361,14950,1949,1384195,59909,1046,130,0
-559021,207357,353613,1949,596787,1018665,836,130,0
-21451,-110505,133905,1949,-1266891,1526217,-2,130,0
580471,-1060190,482318,2599,-1632002,741742,-1049,130,0
290560,29901,-319812,649,145583,-1481391,208,130,0
-442667,985436,-544721,-1952,1630954,-898848,1046,130,0
-445267,-620774,1072540,6499,-946398,1626555,418,130,0
30000,30000,30000,90000,60000,60000,180000,124,1
142355,-62403,-78653,1299,-704667,-923775,-211,130,0
-59153,-886634,949685,3898,-1366181,1458558,-1,130,0
-69840,44499,25340,-1,71199,40544,-1,124,1
0,0,0,0,0,0,0,124,1
-74292,235162,-160869,1,304328,-208184,1,124,1
-706577,-247010,954885,1298,-409939,1574187,-2,130,0
-537,117,420,0,3396,12138,0,124,1
-341263,247009,96853,2599,1145815,435703,1046,130,0
-3673,-1888,5562,1,-5452,16060,0,124,1
959435,-874283,-82554,2598,-1346072,-128407,-211,130,0
11700,-128055,118304,1949,-1472593,1348585,-1,130,0
-8820,8302,518,0,23721,1480,0,124,1
36401,908734,-947736,-2601,1385661,-1441592,1255,130,0
-442017,986086,-546021,-1952,1630744,-900524,626,130,0
-1060190,507669,555770,3249,781123,852134,1255,130,0
9868,-4261,-5607,0,-12176,-16020,1,124,1
-33,135,-102,0,15661,-11848,0,124,1
-48102,326312,-276261,1949,1515115,-1286582,1045,130,0
-20801,-111155,133254,1298,-1267939,1525589,-211,130,0
-114405,-232059,349713,3249,-1070196,1603722,-211,130,0
261309,437466,-697477,1298,1013219,-1615873,417,130,0
-1085541,619473,466717,649,929849,698591,1256,130,0
-843732,-131955,980886,5199,-206750,1506527,627,130,0
-999,1366,-366,1,15777,-4227,1,124,1
-114,129,-14,1,14922,-1707,1,124,1
420565,658474,-1077091,1948,989130,-1619853,627,130,0
239675,-136173,-103501,1,-176224,-133943,0,124,1
-9899,4949,4949,-1,14142,14142,0,124,1
85153,-141706,59802,3249,-1625299,667589,-211,130,0
-91004,137805,-46152,649,1606655,-546724,837,130,0
564221,-323713,-241160,-652,-930688,-697126,-212,130,0
-614,86,527,-1,164,998,0,124,1
276260,770278,-1046540,-2,1159640,-1576073,1046,130,0
-427717,1053039,-624024,1298,1624460,-963575,1255,130,0
330212,-53953,-275611,648,-240475,-1278622,-211,130,0
1063439,-353614,-709827,-2,-536041,-1068102,-211,130,0
240416,-120208,-120208,0,-155563,-155563,0,124,1
-458268,-598023,1060189,3898,-922309,1628650,-1,130,0
85803,809280,-897034,-1951,1338739,-1479925,836,130,0
915884,-136506,-781330,-1952,-226231,-1287420,-2,130,0
156655,-352964,200207,3898,-1629698,914557,-421,130,0
143005,-81254,-59153,2598,-929640,-698382,-420,130,0
656,-418,-238,0,-792,-451,0,124,1
-348414,225558,122854,-2,1048620,560758,1046,130,0
-5040,4744,296,0,13698,854,-1,124,1
0,1224,-1224,0,14145,-14145,0,124,1
299661,265859,-565522,-2,770021,-1632212,417,130,0
416665,-1079041,664974,2598,-1619643,997089,-630,130,0
-156006,-518720,676675,1949,-1199651,1559943,-211,130,0
5172,4723,-9896,-1,13496,-28274,0,124,1
30000,30000,30000,90000,60000,60000,180000,124,1
53768,12885,-66654,-1,20617,-106647,0,124,1
-141,70,70,-1,8167,8167,0,124,1
11061,54952,-66014,-1,87924,-105622,0,124,1
30000,30000,30000,90000,60000,60000,180000,124,1
-27059,-43045,70105,1,-68873,112169,1,124,1
1032238,-261310,-771579,-651,-397161,-1173257,-2,130,0
-75403,336062,-258710,1949,1558476,-1203002,627,130,0
-1084241,583721,503768,3248,878318,754101,1255,130,0
1026388,-823581,-202158,649,-1237775,-304364,-421,130,0
-176807,-376365,555120,1948,-1088211,1599114,-420,130,0
-1057590,752078,306161,649,1130105,457069,1046,130,0
-177457,-375715,555120,1948,-1084860,1600161,-212,130,0
-311362,298361,14950,1949,1384823,58861,1255,130,0
-795630,906783,-112455,-1302,1499405,-186850,1255,130,0
-542771,662374,-116355,3248,1532502,-275248,1465,130,0
267160,-336713,70852,1299,-1548632,322797,-420,130,0
975686,-78003,-897684,-1,-119190,-1350680,418,130,0
505068,-1060840,558370,2598,-1633259,858838,-839,130,0
-226209,691625,-464118,1298,1602884,-1075643,1045,130,0
-730628,1058239,-326313,1298,1595762,-493309,1045,130,0
-63053,139755,-74753,1949,1631582,-889631,1046,130,0
141313,-239099,97786,0,-309422,126546,-1,124,1
1006237,-174857,-828782,2598,-267707,-1261236,207,130,0
-748829,1054339,-304212,1298,1588012,-460631,1046,130,0
-928885,-21451,955535,5199,-34982,1431955,837,130,0
214508,-562272,348413,649,-1618177,1004421,-2,130,0
143655,-72153,-68903,2599,-820296,-812964,-211,130,0
995837,-877533,-115705,2599,-1319469,-174491,-420,130,0
-63703,640273,-575922,648,1484323,-1332875,1256,130,0
141,-70,-70,1,-8167,-8167,0,124,1
482,14,-497,-1,427,-14354,0,124,1
915234,-967237,55252,3249,-1454160,81694,-420,130,0
0,0,0,0,0,0,0,124,1
-796930,906133,-109855,-652,1497520,-182451,1256,130,0
-980887,364013,617523,649,598463,1016989,417,130,0
602572,-1074491,474517,2598,-1630117,719748,-1,130,0
608422,473867,-1080341,1948,712207,-1628860,837,130,0
330212,-53953,-275611,648,-240894,-1277993,418,130,0
-564872,247009,317861,-2,715349,914348,837,130,0
30000,30000,30000,90000,60000,60000,180000,124,1
-1043940,358813,688375,3248,550703,1056370,626,130,0
523269,-77353,-447217,-1301,-221832,-1290352,-211,130,0
-5226,738,4487,-1,2132,12958,0,124,1
749478,-937986,187857,-651,-1544652,311485,-421,130,0
-118955,-3251,125454,3248,-37496,1432793,418,130,0
799529,236608,-1033539,2598,353589,-1557220,627,130,0
30000,30000,30000,90000,60000,60000,180000,124,1
10400,849581,-861933,-1952,1405980,-1423158,836,130,0
-1054340,704626,353613,3899,1070195,534364,1255,130,0
-82554,979586,-897034,-2,1472592,-1348376,836,130,0
178106,374414,-554471,-1951,1086534,-1599324,418,130,0
804730,94253,-900934,-1951,155428,-1485371,627,130,0
-537,420,117,0,12138,3396,0,124,1
0,0,0,0,0,0,0,124,1
986086,-433567,-553821,-1302,-717026,-912464,-421,130,0
-276261,-770279,1048489,1949,-1159851,1576072,-2,130,0
-138456,88403,52001,1948,1032490,580239,836,130,0
-261960,-436817,702026,3249,-1010287,1616710,-210,130,0
-2955,-2699,5654,0,-7793,16328,1,124,1
-1025089,276260,751428,2599,424391,1154194,1046,130,0
-1034839,768328,271060,4549,1167391,406586,1256,130,0
432266,98803,-531720,-651,286768,-1535645,418,130,0
840481,160556,-998438,2599,241940,-1519306,836,130,0
-940586,739727,200207,-652,1222063,328453,1046,130,0
-211258,559020,-347764,-2,1618176,-1005260,627,130,0
0,-208206,208206,0,-269443,269443,0,124,1
-1001038,198907,806680,4549,302897,1238821,1046,130,0
-656,418,238,0,792,451,0,124,1
-5547,-58274,63822,1,-93239,102115,0,124,1
-1077741,414065,665624,1948,622343,996880,837,130,0
738,-1413,674,-1,-16328,7793,-1,124,1
-349714,1040688,-690976,-2,1605398,-1065169,627,130,0
579171,-643525,66302,1948,-1484743,152077,-420,130,0
68756,-48674,-20082,0,-77878,-32132,1,124,1
30000,30000,30000,90000,60000,60000,180000,124,1
891183,76702,-964637,3248,115419,-1468195,836,130,0
-430,-103,533,0,-2976,15397,1,124,1
-216,560,-344,0,16194,-9943,1,124,1
-1548,-7693,9241,0,-21981,26405,0,124,1
-1060840,579171,483618,1949,890468,741114,1256,130,0
45922,23603,-69526,-1,37765,-111242,-1,124,1
-668226,-378965,1049139,1948,-584848,1612939,208,130,0
137805,841131,-977637,1299,1296845,-1508413,1046,130,0
100,36,-136,0,4227,-15777,0,124,1
-124805,117654,9100,1949,1373093,80646,1255,130,0
0,0,0,0,0,0,0,124,1
876232,-958786,85803,3249,-1475526,130501,-420,130,0
-189158,-164457,355563,1948,-756616,1631792,-211,130,0
551220,-165107,-388065,-1952,-472361,-1118166,-630,130,0
-52,599,-547,0,1136,-1037,1,124,1
30000,30000,30000,90000,60000,60000,180000,124,1
35101,100753,-133906,1948,1181635,-1567275,1046,130,0
-9414,2058,7356,0,5880,21019,0,124,1
313311,390664,-703977,-2,904503,-1629907,628,130,0
141055,-52652,-87104,1299,-589247,-1024531,-210,130,0
40951,-508970,469317,1298,-1469242,1353193,-211,130,0
-4823,4971,-148,0,14354,-427,0,124,1
-529120,1071240,-542121,-1,1634096,-825742,1465,130,0
457,-516,59,0,-14922,1707,-1,124,1
-9414,2058,7356,0,5880,21019,0,124,1
-156137,-80252,236390,1,-103856,305917,1,124,1
969186,-112455,-854783,1948,-176795,-1317584,-211,130,0
0,0,0,0,0,0,0,124,1
770928,-1018589,250259,2598,-1567485,384382,-840,130,0
-11,127,-116,0,14742,-13461,0,124,1
127404,-8451,-116355,2598,-85884,-1369323,-1,130,0
1051739,-646125,-404316,1298,-995415,-624020,-631,130,0
1064739,-352314,-711127,1298,-533318,-1070196,-1,130,0
258709,785879,-1042640,1948,1180169,-1567904,836,130,0
30000,30000,30000,90000,60000,60000,180000,124,1
21450,928234,-950336,-652,1398020,-1430908,1046,130,0
-87104,-253510,341912,1298,-1167601,1573349,-211,130,0
-373765,1056939,-683176,-2,1611054,-1040661,1255,130,0
-4576,-591,5167,0,-1707,14922,1,124,1
-481019,497268,-16251,-2,1439496,-49855,1256,130,0
-8820,518,8302,0,1480,23721,0,124,1
30000,30000,30000,90000,60000,60000,180000,124,1
918,-1390,472,0,-16060,5452,0,124,1
969186,-58503,-910035,648,-89864,-1367229,208,130,0
-118305,661724,-542771,648,1532921,-1255580,1046,130,0
-999,-366,1366,1,-4227,15777,1,124,1
-119605,-862583,987386,5198,-1313185,1498567,417,130,0
91003,249609,-339963,649,1163201,-1574607,836,130,0
-21850,69165,-47314,1,110664,-75703,0,124,1
-332813,1062139,-727378,1948,1597438,-1095124,836,130,0
340612,723477,-1063440,649,1086744,-1599115,837,130,0
-90354,137805,-46152,1299,1608121,-552380,1255,130,0
960735,-689676,-272361,-1302,-1137228,-447225,-840,130,0
-940586,742327,196957,-1302,1225624,323216,1046,130,0
-597373,1080990,-482319,1298,1630744,-728128,1255,130,0
-480368,497918,-16901,649,1440753,-52788,1255,130,0
-341913,246359,96203,649,1146234,435284,1046,130,0
-53768,-12885,66654,1,-20617,106647,0,124,1
278210,768978,-1047190,-2,1157546,-1576492,1256,130,0
-156137,236390,-80252,1,305917,-103856,1,124,1
41601,-956836,920434,5199,-1443267,1384823,417,130,0
432916,96853,-531070,-1301,283835,-1534807,208,130,0
170000,62224,-232224,0,80525,-300525,0,124,1
-541471,662374,-119605,1298,1534596,-280694,1464,130,0
770278,279510,-1049140,648,416850,-1575864,207,130,0
943185,-922385,-18851,1949,-1399488,-30584,-631,130,0
-1040039,248959,793679,2599,373280,1190642,627,130,0
88,439,-528,-1,12694,-15249,0,124,1
-443967,-621424,1072540,7149,-947445,1626345,-1,130,0
-256,-308,564,0,-8896,16311,0,124,1
-212558,559020,-345813,649,1618595,-1001280,836,130,0
-234009,-111805,349063,3249,-514465,1599533,-1,130,0
-850232,-13651,866482,2599,-25975,1427556,627,130,0
-44852,-588923,635723,1948,-1359269,1464423,-421,130,0
-1083591,583071,503768,3248,877690,754939,1674,130,0
109854,23400,-131305,1949,290119,-1536692,208,130,0
1027038,-822281,-202808,1949,-1236727,-306040,-420,130,0
-767679,1016638,-247010,1949,1567484,-383754,1466,130,0
-5587,3559,2027,-1,10279,5853,-1,124,1
-221,-1099,1320,0,-12694,15249,0,124,1
-128055,348413,-219059,1299,1615872,-1016153,627,130,0
-9625,6814,2811,0,19469,8033,0,124,1
-934736,11050,928234,4548,13406,1408075,837,130,0
1041339,-352964,-688376,-1,-545677,-1060561,-630,130,0
-809931,1029638,-219709,-2,1551773,-332434,1255,130,0
0,-489,489,0,-14145,14145,0,124,1
482,14,-497,-1,427,-14354,0,124,1
-1414,707,707,0,8167,8167,0,124,1
348413,-228809,-119605,-1,-1051553,-557198,-839,130,0
550570,-165757,-387415,-2602,-473199,-1117118,-1,130,0
547970,-1086841,542120,3249,-1633887,813382,-420,130,0
642,770,-1412,0,8896,-16311,0,124,1
5040,-4744,-296,0,-13698,-854,1,124,1
-106604,131954,-24701,649,1542347,-303736,1465,130,0
-105954,131954,-24701,1299,1541509,-301851,1046,130,0
-216,560,-344,0,16194,-9943,1,124,1
0,0,0,0,0,0,0,124,1
-1051090,763778,289910,2598,1148538,432142,1046,130,0
-674726,520669,156005,1948,1203211,355684,1256,130,0
-592,557,34,-1,1055,65,-1,124,1
-656525,555120,102703,1298,1283858,233143,1047,130,0
0,0,0,0,0,0,0,124,1
30000,30000,30000,90000,60000,60000,180000,124,1
942535,-922385,-18201,1949,-1399906,-29327,-211,130,0
-347,-317,664,0,-600,1258,1,124,1
431616,-1055640,625973,1949,-1624461,962526,-421,130,0
60290,1850,-62141,-1,2961,-99426,0,124,1
5172,-9896,4723,-1,-28274,13496,0,124,1
-572672,-512870,1088790,3248,-772117,1632420,-2,130,0
-605173,-473218,1084240,5849,-716188,1629488,418,130,0
959435,-874933,-81904,2598,-1346910,-127569,-839,130,0
215158,-1018589,807330,3899,-1548423,1226253,-420,130,0
-99454,-37052,138455,1949,-420622,1576910,208,130,0
873632,-960086,88403,1949,-1477621,135109,-421,130,0
-969187,911334,57852,-1,1371208,83998,1465,130,0
0,61237,-61237,0,97979,-97979,0,124,1
3325,-5625,2300,0,-16244,6643,-1,124,1
139105,-98804,-38352,1949,-1128639,-458746,-839,130,0
-6429,9733,-3304,0,27810,-9441,0,124,1
-422516,700726,-275611,2599,1622575,-642663,1674,130,0
222115,-190735,-31380,0,-246833,-40610,0,124,1
4576,591,-5167,0,1707,-14922,-1,124,1
-182813,-43812,226626,1,-56698,293281,1,124,1
-233359,-113105,349063,2599,-519283,1600371,-211,130,0
592,-557,-34,1,-1055,-65,1,124,1
-993238,876232,119604,2598,1318630,176585,1465,130,0
-273661,1023138,-748179,1298,1578167,-1154823,1047,130,0
375714,-1069291,696826,3249,-1609379,1048201,-211,130,0
943185,-213208,-730628,-651,-352543,-1204887,-420,130,0
-83204,979586,-896384,-2,1473221,-1347538,837,130,0
0,-1224,1224,0,-14145,14145,0,124,1
-1059540,314611,747528,2599,469847,1120050,837,130,0
-563572,325012,239858,1298,937390,690421,1046,130,0
457617,599972,-1056290,1299,923146,-1628232,418,130,0
-427066,533019,-106604,-651,1544442,-310439,1046,130,0
587622,395864,-982837,649,652716,-1622576,836,130,0
30000,30000,30000,90000,60000,60000,180000,124,1
0,-1224,1224,0,-14145,14145,0,124,1
132,-542,410,0,-15661,11848,0,124,1
-537,607,-69,1,1149,-131,0,124,1
537570,-424466,-113755,-651,-1221645,-328454,-421,130,0
-848282,1008187,-157956,1949,1519933,-240266,1464,130,0
0,0,0,0,0,0,0,124,1
505,121,-626,0,229,-1186,0,124,1
306811,1950,-305512,3249,11520,-1420225,-211,130,0
30000,30000,30000,90000,60000,60000,180000,124,1
146905,-1004288,861282,3899,-1511136,1293284,-420,130,0
-689676,479067,213207,2598,1107482,486605,1047,130,0
30000,30000,30000,90000,60000,60000,180000,124,1
-132,-410,542,0,-11848,15661,0,124,1
884,4396,-5281,-1,12694,-15249,0,124,1
-988688,434866,555120,1298,716187,913510,837,130,0
44851,-139756,96853,1948,-1596811,1097636,-840,130,0
-1067340,640273,430966,3899,972372,651041,1256,130,0
299011,265859,-565522,-652,769393,-1632212,417,130,0
646,-188,-457,1,-357,-866,0,124,1
-367,556,-188,1,16060,-5452,0,124,1
332,-562,230,0,-16244,6643,-1,124,1
-494019,-190458,687075,2598,-441988,1582775,417,130,0
1073190,-687726,-384815,649,-1033748,-578564,-420,130,0
-120905,993237,-871033,1299,1497310,-1313813,1046,130,0
83,-140,57,0,-16244,6643,-1,124,1
300961,-315262,15600,1299,-1447876,68497,-421,130,0
-523920,1082290,-558371,-1,1633677,-843338,1255,130,0
135855,406915,-543421,-651,1179331,-1568323,836,130,0
105303,-345813,242459,1949,-1591783,1113766,-420,130,0
-839832,873632,-35102,-1302,1443895,-59281,1256,130,0
533019,-1075791,546670,3898,-1633887,828464,-1,130,0
-31852,-104004,137155,1299,-1182683,1567065,-210,130,0
-558371,358813,200207,649,1036261,576049,1046,130,0
-11,-116,127,0,-13461,14742,0,124,1
507018,-681876,176806,1948,-1573559,405329,-630,130,0
-288611,-31202,322412,2599,-142651,1480552,836,130,0
-1020539,191757,832681,3899,286558,1249714,837,130,0
313961,-301612,-11051,1298,-1385453,-57605,-839,130,0
235308,109854,-344513,649,515093,-1599534,418,130,0
0,0,0,0,0,0,0,124,1
-335413,-227509,563571,649,-656278,1623413,209,130,0
-863233,1001687,-137806,648,1508203,-209473,1465,130,0
-565,282,282,-1,8167,8167,0,124,1
-2568,-3080,5649,1,-8896,16311,0,124,1
22750,108554,-131305,-1,1267309,-1526009,1046,130,0
494668,-1086841,594122,1949,-1631583,891515,-211,130,0
-403016,-142356,546020,648,-410357,1574396,208,130,0
-1375,401,973,-1,4639,11243,0,124,1
-492719,-190458,686425,3248,-441778,1582775,418,130,0
-4823,-148,4971,0,-427,14354,0,124,1
-282761,-754029,1041989,5199,-1147911,1580890,-2,130,0
30000,30000,30000,90000,60000,60000,180000,124,1
2164,3443,-5608,-1,9943,-16194,-1,124,1
-27059,-43045,70105,1,-68873,112169,1,124,1
599322,456967,-1056290,-1,702152,-1627813,417,130,0
414715,-1078391,666274,2598,-1619015,999394,-211,130,0
1039388,-247010,-790430,1948,-373071,-1190434,-1,130,0
-1017289,770278,249609,2598,1185615,381240,1465,130,0
-224259,347763,-121555,1949,1611054,-570185,837,130,0
-1062140,509619,553820,1299,783637,849830,1255,130,0
-592,34,557,-1,65,1055,-1,124,1
-8008,-1034,9043,1,-2956,25838,0,124,1
757278,172256,-930185,-651,283835,-1534388,836,130,0
-61103,968536,-906784,649,1459396,-1365553,1256,130,0
108554,-967237,861282,2599,-1490399,1324705,-2,130,0
-484919,-10401,495968,648,-31631,1430070,208,130,0
591522,480367,-1071891,-2,731059,-1630117,836,130,0
5818,-9845,4026,-1,-28129,11504,0,124,1
-241160,-710477,952285,648,-1174304,1570626,-210,130,0
-988688,434866,554470,648,716396,913300,626,130,0
-936686,-2601,945135,5848,-7123,1418130,627,130,0
74292,160869,-235162,-1,208184,-304328,-1,124,1
657824,418615,-1075791,648,629674,-1619643,417,130,0
354263,-159256,-193708,1299,-728337,-901990,-630,130,0
-133906,105303,31201,2598,1217664,335156,1255,130,0
-91,-47,139,1,-5452,16060,0,124,1
642,770,-1412,0,8896,-16311,0,124,1
3673,1888,-5562,-1,5452,-16060,0,124,1
70492,-40050,-30441,1,-64081,-48706,1,124,1
-169657,-843082,1017288,4549,-1268777,1525380,-2,130,0
-1044590,275610,774829,5849,412242,1162992,1046,130,0
0,0,0,0,0,0,0,124,1
-113105,-233359,349063,2599,-1074176,1602884,-421,130,0
-237259,-712427,951635,1949,-1177237,1569578,-211,130,0
842431,172906,-1014038,1299,258908,-1525590,837,130,0
579171,-644175,65002,-2,-1483696,149354,-630,130,0
-730628,-299662,1033538,3248,-463145,1588012,417,130,0
1950,939935,-941886,-1,1413521,-1415407,1046,130,0
74292,-235162,160869,-1,-304328,208184,-1,124,1
522,-448,-73,1,-12958,-2132,0,124,1
-1060840,579171,482318,649,891934,739648,1256,130,0
2164,-5608,3443,-1,-16194,9943,-1,124,1
0,0,0,0,0,0,0,124,1
99,-136,36,-1,-15777,4227,-1,124,1
63003,-59302,-3700,1,-94884,-5921,0,124,1
-634424,973086,-339313,-651,1610007,-561597,1256,130,0
0,0,0,0,0,0,0,124,1
-411466,1075140,-663025,649,1619014,-998138,836,130,0
278210,770278,-1046540,1948,1159012,-1576073,1046,130,0
-174,553,-378,1,15977,-10929,1,124,1
-541,1402,-860,1,16194,-9943,1,124,1
457,59,-516,0,1707,-14922,-1,124,1
21850,47314,-69165,-1,75703,-110664,0,124,1
30000,30000,30000,90000,60000,60000,180000,124,1
1073190,-390665,-681876,649,-588409,-1025160,208,130,0
690975,-1073841,385464,2598,-1612521,578144,-420,130,0
8440,-8699,259,0,-24856,740,0,124,1
-937336,-3901,946435,5198,-8798,1418758,208,130,0
958135,-876233,-80604,1298,-1348376,-125056,-840,130,0
73,-141,67,-1,-16328,7793,-1,124,1
-205,-444,650,1,-842,1231,1,124,1
-132,542,-410,0,15661,-11848,0,124,1
841781,174206,-1014038,1949,259955,-1526009,836,130,0
-968537,913284,55252,-1,1373093,80437,1255,130,0
-193708,-826831,1024438,3899,-1245316,1538157,-212,130,0
-689026,481018,210607,2599,1111671,481158,1255,130,0
30000,30000,30000,90000,60000,60000,180000,124,1
-2955,5654,-2699,0,16328,-7793,1,124,1
-453717,-241810,698126,2599,-560968,1608540,-211,130,0
1205,37,-1242,0,427,-14354,0,124,1
-747529,1054339,-305512,1298,1588221,-461469,1045,130,0
56124,174391,-230515,0,225683,-298314,0,124,1
191757,161206,-351664,1299,754730,-1631583,628,130,0
194500,25130,-219631,-1,32521,-284228,0,124,1
-1014689,838531,178756,2598,1263120,266449,1675,130,0
-273011,-58503,332812,1298,-266450,1528731,417,130,0
-66953,887283,-821631,-1301,1467146,-1355708,836,130,0
945135,-936686,-5201,3248,-1410380,-8798,-1,130,0
0,0,0,0,0,0,0,124,1
1320,-5423,4103,0,-15661,11848,0,124,1
-768329,1015988,-245710,1949,1567065,-382079,1674,130,0
-311362,298361,14300,1299,1386080,55719,836,130,0
-297062,-752079,1053689,4548,-1135552,1584870,-1,130,0
-156137,-80252,236390,1,-103856,305917,1,124,1
614,-527,-86,1,-998,-164,0,124,1
371163,-1067991,700076,3248,-1608122,1054276,-420,130,0
380914,666274,-1046540,648,1025368,-1613359,627,130,0
381564,687725,-1068641,648,1036470,-1611055,417,130,0
-91,-47,139,1,-5452,16060,0,124,1
-4000,-1464,5464,0,-4227,15777,0,124,1
-22,-109,132,1,-12694,15249,0,124,1
1024438,-277561,-746878,-1,-427953,-1151053,-211,130,0
136505,-31202,-103354,1949,-343536,-1210962,-211,130,0
-470,-172,642,0,-325,1215,0,124,1
0,-1224,1224,0,-14145,14145,0,124,1
-3901,-938636,945785,3248,-1410799,1418758,-211,130,0
125617,114716,-240333,0,148456,-311020,-1,124,1
1043289,-779380,-262610,1299,-1174723,-395904,-630,130,0
-204758,-809931,1017938,3249,-1232747,1545070,418,130,0
-239675,103501,136173,-1,133943,176224,0,124,1
828781,195657,-1023139,1299,292214,-1537321,836,130,0
569421,-1087491,522619,4549,-1633469,783008,-421,130,0
-2164,-3443,5608,1,-9943,16194,1,124,1
537,-607,69,-1,-1149,131,0,124,1
-297062,963986,-668876,-1952,1594925,-1104131,837,130,0
-977637,629223,348413,-1,1039403,572279,1046,130,0
-846982,1009487,-159906,2599,1521190,-244036,1465,130,0
-332,562,-230,0,16244,-6643,1,124,1
0,0,0,0,0,0,0,124,1
-722828,-338013,1066039,5198,-510904,1598695,-211,130,0
-212558,-138456,353613,2599,-636169,1620690,-1,130,0
-1084891,618823,468017,1949,927964,700686,1047,130,0
-928885,-20151,954885,5849,-33726,1431117,627,130,0
141,-70,-70,1,-8167,-8167,0,124,1
70710,-35355,-35355,0,-56568,-56568,1,124,1
0,0,0,0,0,0,0,124,1
1032238,-261960,-770279,-1,-399046,-1172000,-1,130,0
-8008,-1034,9043,1,-2956,25838,0,124,1
-106604,131954,-24701,649,1542556,-304783,1255,130,0
3999,-5464,1464,-1,-15777,4227,-1,124,1
1086840,-546671,-540821,-652,-820924,-812336,-211,130,0
-390,-270,661,1,-511,1251,1,124,1
68756,-48674,-20082,0,-77878,-32132,1,124,1
0,0,0,0,0,0,0,124,1
-704627,297061,409515,1949,684766,941789,628,130,0
-54,-86,140,0,-9943,16194,1,124,1
484268,11050,-497269,-1951,34562,-1431327,-2,130,0
-1006888,148855,861932,3899,221622,1290980,1047,130,0
-566172,246359,319161,-652,711997,917280,836,130,0
-233359,-113755,349063,1949,-521587,1600999,-1,130,0
-493369,-190458,687075,3248,-440731,1582147,-1,130,0
507669,-681876,176806,2599,-1573350,405120,-630,130,0
-364014,-690326,1060839,6499,-1052601,1608331,208,130,0
-693576,956185,-263910,-1301,1581518,-434866,1255,130,0
0,0,0,0,0,0,0,124,1
204757,-352964,152105,3898,-1627813,693564,-420,130,0
-216459,-809931,1030288,3898,-1221645,1550307,208,130,0
-788480,-217759,1011437,5198,-338299,1553030,417,130,0
-382865,-664325,1049139,1949,-1025369,1613777,-1,130,0
-537,117,420,0,3396,12138,0,124,1
757278,172906,-930185,-1,284254,-1534807,417,130,0
-237456,86157,151298,-1,111497,195798,-1,124,1
-509620,987386,-479068,-1302,1633886,-791598,836,130,0
12350,-128055,118304,2599,-1472803,1348375,-2,130,0
458267,-518720,61752,1299,-1495845,179518,-1,130,0
135205,-990638,859982,4549,-1504433,1304386,418,130,0
91653,436166,-527820,-1,1265215,-1527266,837,130,0
1005587,-175507,-828782,1298,-267497,-1261445,208,130,0
-771579,-274311,1051739,5849,-414756,1575444,209,130,0
-59153,-272361,334112,2598,-1253695,1533759,-211,130,0
787829,222308,-1007538,2599,340393,-1553240,628,130,0
0,8573,-8573,0,24494,-24494,0,124,1
-977637,629223,348413,-1,1039822,572069,1255,130,0
-9899,4949,4949,-1,14142,14142,0,124,1
-52002,138455,-84504,1949,1620061,-994577,1045,130,0
65652,76052,-139106,2598,888164,-1630955,418,130,0
93603,-141056,49401,1948,-1606656,546933,-420,130,0
11061,-66014,54952,-1,-105622,87924,0,124,1
-91004,-437467,529119,648,-1264797,1527684,-421,130,0
-7527,9331,-1804,0,26661,-5154,0,124,1
-273011,-57853,333462,2598,-265402,1528522,837,130,0
691625,-480368,-209958,1299,-1107273,-486606,-840,130,0
-831,-575,1406,0,-6643,16244,1,124,1
-278861,-768329,1049789,2599,-1157756,1576910,-420,130,0
30000,30000,30000,90000,60000,60000,180000,124,1
155,-637,482,0,-1206,912,-1,124,1
635073,-590873,-42902,1298,-1361363,-101804,-1048,130,0
942535,-213208,-730628,-1301,-352124,-1205097,-420,130,0
-800831,-230109,1035488,4548,-348982,1556591,627,130,0
55252,888583,-944486,-651,1370579,-1454788,1046,130,0
-128705,111154,18850,1299,1300825,205911,1255,130,0
0,0,0,0,0,0,0,124,1
942535,-923035,-17551,1949,-1400325,-28489,-420,130,0
-426416,533669,-106604,649,1544861,-311277,1256,130,0
-366614,-688376,1060839,5849,-1049668,1608750,418,130,0
-751429,1052389,-300312,648,1586546,-454137,1465,130,0
-351664,1041339,-689026,649,1605817,-1063074,1046,130,0
-945136,217108,729977,1949,356313,1202582,837,130,0
-72153,139755,-65653,1949,1633468,-781124,1256,130,0
-838532,-174857,1018588,5199,-265193,1528522,837,130,0
1548,7693,-9241,0,21981,-26405,0,124,1
30000,30000,30000,90000,60000,60000,180000,124,1
783279,260659,-1041340,2598,389200,-1567904,417,130,0
-955536,923684,34451,2599,1390060,48807,1255,130,0
61752,-968537,910684,3899,-1458140,1367018,-630,130,0
51351,-329563,280810,2598,-1515745,1285743,-420,130,0
-842432,-170957,1017288,3899,-259747,1526427,417,130,0
-592,557,34,-1,1055,65,-1,124,1
367,188,-556,-1,5452,-16060,0,124,1
141705,-90354,-50052,1299,-1029349,-583801,-211,130,0
74292,-235162,160869,-1,-304328,208184,-1,124,1
218408,-1019239,805380,4549,-1549889,1222901,-211,130,0
-70710,35355,35355,0,56568,56568,-1,124,1
142355,837881,-980237,-1,1292237,-1511136,1047,130,0
-1025739,823580,204107,1948,1239240,302478,1046,130,0
5040,-4744,-296,0,-13698,-854,1,124,1
-140406,60452,81253,1299,707808,921051,837,130,0
59802,885983,-945786,-1,1366809,-1457930,837,130,0
669525,-1075141,406915,1299,-1617968,612707,-212,130,0
-315262,-654575,969836,-1,-1082555,1600371,-210,130,0
-9777,3547,6229,-1,10136,17799,-1,124,1
-120,-3,124,1,-427,14354,0,124,1
920434,-919135,1300,2599,-1414988,0,-838,130,0
532369,527819,-1059540,648,812335,-1632840,837,130,0
0,0,0,0,0,0,0,124,1
43551,-510270,467367,648,-1471546,1350051,-420,130,0
-432917,-98804,532369,648,-285093,1535434,626,130,0
-120,-3,124,1,-427,14354,0,124,1
57206,7391,-64597,0,11826,-103355,0,124,1
-332,562,-230,0,16244,-6643,1,124,1
-768979,1015988,-245060,1949,1566646,-380612,1465,130,0
-219709,-341263,562271,1299,-986407,1620690,-210,130,0
-654575,-419916,1079040,4549,-633236,1620480,208,130,0
56552,887933,-943836,649,1369532,-1455626,1046,130,0
648074,324362,-971137,1299,533317,-1603095,417,130,0
-962037,687725,273660,-652,1135760,449318,836,130,0
299011,-967237,668875,649,-1594926,1103502,-630,130,0
-559021,207357,352963,1299,598253,1017408,836,130,0
-1041990,781329,264559,3898,1175141,395693,1255,130,0
-839832,-158606,1002987,4549,-242779,1520352,418,130,0
-995838,874932,120904,-2,1317164,179308,1255,130,0
-221,1320,-1099,0,15249,-12694,0,124,1
-848282,-16901,867782,2599,-30584,1429651,417,130,0
-193708,-827482,1023788,2598,-1245525,1537948,-1,130,0
42251,-509620,468017,648,-1470499,1351517,-421,130,0
-927585,-22101,956185,6499,-37287,1433002,626,130,0
-5851,-302912,311361,2598,-1398440,1430488,-421,130,0
-44,510,-466,0,14742,-13461,0,124,1
1548,-9241,7693,0,-26405,21981,0,124,1
-617524,1080340,-460868,1948,1628231,-696707,1046,130,0
205407,809280,-1014038,649,1233794,-1543605,1046,130,0
226858,-349714,126104,3248,-1611474,571650,-840,130,0
958135,-924985,-31852,1298,-1390271,-48389,-840,130,0
-103,620,-516,1,1175,-978,1,124,1
-470618,1080340,-609723,-1,1629488,-919167,1255,130,0
-350364,1041339,-689676,1299,1605608,-1064122,1046,130,0
-140,80,60,0,9251,7032,0,124,1
23400,108554,-131305,649,1265424,-1527056,1046,130,0
-47452,-464118,512869,1299,-1339788,1479505,-211,130,0
770278,-1052390,284060,1948,-1578796,425229,-211,130,0
30000,30000,30000,90000,60000,60000,180000,124,1
685775,-194358,-491419,-2,-447015,-1137228,-839,130,0
109146,-240086,130940,0,-310700,169451,-1,124,1
-1748,5533,-3785,0,15977,-10929,1,124,1
314611,-1057590,746227,3248,-1590108,1120259,-421,130,0
-100104,-555771,658474,2599,-1284068,1516163,-420,130,0
826830,197607,-1023139,1298,293471,-1537949,418,130,0
-261310,-437467,701376,2599,-1010706,1616500,-211,130,0
70852,-889884,819680,648,-1469242,1353193,-211,130,0
-41562,70323,-28760,1,112517,-46016,1,124,1
530419,136505,-668876,-1952,319236,-1546537,418,130,0
43,94,-138,-1,10929,-15977,-1,124,1
801480,233358,-1032239,2599,348353,-1555754,627,130,0
32101,38511,-70613,-1,61618,-112982,-1,124,1
135205,406915,-543421,-1301,1179540,-1568113,1046,130,0
-5500,3893,1606,-1,11243,4639,0,124,1
-317862,24050,295111,1299,116047,1352984,417,130,0
-122205,-861283,988037,4549,-1311300,1500033,207,130,0
-828132,-195658,1026388,2598,-294729,1538995,626,130,0
-564872,1084890,-520670,-652,1633468,-784057,1046,130,0
884,4396,-5281,-1,12694,-15249,0,124,1
-33802,-287961,323712,1949,-1329105,1487256,-1,130,0
-119605,992587,-871683,1299,1496472,-1315489,1045,130,0
-670826,139105,532369,648,320702,1226881,836,130,0
884,4396,-5281,-1,12694,-15249,0,124,1
-11,-116,127,0,-13461,14742,0,124,1
-651325,86453,567471,2599,197323,1305643,837,130,0
696826,-245060,-451767,-1,-563273,-1045898,-212,130,0
0,0,0,0,0,0,0,124,1
93603,46151,-137156,2598,541067,-1604980,208,130,0
-586322,-495319,1086190,4549,-746980,1631373,418,130,0
-5547,63822,-58274,1,102115,-93239,0,124,1
-843732,995837,-150806,1299,1516582,-231258,1465,130,0
-1025089,277560,750128,2599,425229,1153356,836,130,0
-587623,-494019,1086840,5198,-745304,1631163,-1,130,0
0,-122855,124804,1949,-1411637,1417501,-211,130,0
1053689,-341263,-710477,1949,-520121,-1080880,-211,130,0
-656,238,418,0,451,792,0,124,1
876882,-958136,83203,1949,-1474269,127568,-421,130,0
-328263,705276,-374415,2598,1632839,-870150,1255,130,0
30000,30000,30000,90000,60000,60000,180000,124,1
132604,-19501,-111155,1948,-214710,-1294542,208,130,0
850881,-1010138,161856,2599,-1520772,243197,-211,130,0
-648075,-323063,973086,1948,-534784,1603932,-1,130,0
0,0,0,0,0,0,0,124,1
-141056,-211258,353613,1299,-972163,1622575,-630,130,0
69840,-44499,-25340,1,-71199,-40544,1,124,1
570071,-1087491,521969,4549,-1633678,782380,-420,130,0
178756,374414,-554471,-1301,1085068,-1599534,627,130,0
-670826,139755,533019,1948,321121,1226462,836,130,0
0,0,0,0,0,0,0,124,1
-18862,-198133,216996,1,-256407,280818,1,124,1
-375715,705276,-327613,1948,1632839,-761015,1255,130,0
-139,50,88,-1,5853,10279,-1,124,1
-223609,347763,-122205,1949,1611473,-572070,1046,130,0
5200,486218,-492069,-651,1409332,-1420016,836,130,0
0,0,0,0,0,0,0,124,1
1086840,-544721,-542771,-652,-818829,-814640,-211,130,0
-367,556,-188,1,16060,-5452,0,124,1
78002,-338013,262609,2598,-1558058,1204049,-420,130,0
-46802,-464768,512219,649,-1341045,1478458,-211,130,0
-156137,236390,-80252,1,305917,-103856,1,124,1
70710,-35355,-35355,0,-56568,-56568,1,124,1
-962687,685775,275610,-1302,1133037,453089,1046,130,0
214508,-561622,347763,649,-1618386,1002955,-210,130,0
843081,157955,-997788,3248,239008,-1518259,836,130,0
8440,259,-8699,0,740,-24856,0,124,1
30000,30000,30000,90000,60000,60000,180000,124,1
30000,30000,30000,90000,60000,60000,180000,124,1
-648075,-323063,973086,1948,-534156,1603722,-2,130,0
1004937,-867133,-136506,1298,-1301035,-205284,-420,130,0
-493369,-189808,687075,3898,-440103,1582147,208,130,0
685125,-193058,-492069,-2,-445758,-1137647,-420,130,0
-70203,888583,-819031,-651,1469869,-1352356,1046,130,0
-67603,887933,-819681,649,1468194,-1354660,837,130,0
-1344,1050,294,0,12138,3396,0,124,1
-252210,562921,-312012,-1301,1630954,-899895,627,130,0
-178107,352313,-172257,1949,1633886,-802490,1255,130,0
576571,-987387,410165,-651,-1626346,678272,-420,130,0
-617524,1080340,-461518,1298,1628231,-696288,1255,130,0
607122,474517,-1080341,1298,713882,-1628860,627,130,0
987386,-435517,-552521,-652,-719749,-909950,-421,130,0
132,-542,410,0,-15661,11848,0,124,1
11050,-618174,609072,1948,-1425881,1403048,-210,130,0
980236,-874933,-103354,1949,-1328895,-158781,-420,130,0
-1951,-489469,492068,648,-1411009,1418549,-2,130,0
11700,-128705,118954,1949,-1473431,1347537,-211,130,0
-7151,614923,-606473,1299,1424414,-1404305,837,130,0
0,0,0,0,0,0,0,124,1
-370514,1066689,-695527,648,1609378,-1049249,1046,130,0
-129355,16900,115054,2599,213662,1295588,627,130,0
799529,-908085,109854,1298,-1497311,182660,-629,130,0
-64,141,-77,0,16311,-8896,0,124,1
-1066690,423165,647424,3899,642033,980122,1045,130,0
122854,861282,-983487,649,1312765,-1497730,1465,130,0
-522620,-465418,989337,1299,-769394,1632420,-211,130,0
0,0,0,0,0,0,0,124,1
8450,-616224,610372,2598,-1423158,1406190,-420,130,0
181356,-354264,175506,2598,-1633887,806679,-839,130,0
-92003,238359,-146356,0,308465,-189402,0,124,1
866482,-1003638,139105,1949,-1507156,207796,-211,130,0
0,0,0,0,0,0,0,124,1
1042639,-778730,-262610,1299,-1174304,-396323,-211,130,0
-604523,-475168,1083590,3899,-717444,1629697,627,130,0
-656,418,238,0,792,451,0,124,1
-129355,18200,114404,3249,217013,1293284,417,130,0
-524570,78002,446566,-2,226649,1287838,837,130,0
193707,828131,-1021189,649,1246362,-1537530,1046,130,0
101403,555120,-655225,1298,1284695,-1515745,1045,130,0
-559021,358163,200207,-651,1036680,575421,837,130,0
-120255,992587,-871033,1299,1496891,-1314442,1255,130,0
-165757,-761829,928234,648,-1258722,1531035,-211,130,0
5040,-4744,-296,0,-13698,-854,1,124,1
0,-122,122,0,-14145,14145,0,124,1
-106604,-26001,135205,2600,-294729,1538576,417,130,0
1036788,-767679,-267161,1948,-1166344,-407215,-1,130,0
-564222,324362,239858,-2,936133,691678,836,130,0
-879483,833331,45501,-651,1377492,72687,1256,130,0
-364664,555770,-190458,648,1608121,-552380,1255,130,0
266509,-337363,72152,1298,-1550098,327615,-629,130,0
132,410,-542,0,11848,-15661,0,124,1
-50000,-18301,68301,0,-29282,109282,0,124,1
-234009,-111805,348413,2599,-515722,1599742,-211,130,0
267160,-336713,70852,1299,-1548842,323425,-631,130,0
-671476,139755,532369,648,321750,1225834,418,130,0
8008,-9043,1034,-1,-25838,2956,0,124,1
-575922,641574,-64353,1299,1485370,-152916,1255,130,0
-300962,-749479,1054989,4548,-1131991,1586127,208,130,0
986086,-566822,-419916,-652,-935715,-691889,-630,130,0
-927585,-22751,956835,6499,-38543,1433421,418,130,0
1060189,-329563,-730628,-2,-495822,-1099942,-630,130,0
943185,-216459,-728028,-1302,-358199,-1200907,-1,130,0
157955,-353614,198907,3248,-1629907,911206,-420,130,0
-524570,1082290,-558371,-651,1633677,-842081,1046,130,0
-891184,-52652,947085,3249,-83999,1454787,836,130,0
-349714,131304,220358,1948,609146,1007773,418,130,0
-303562,-3251,309411,2598,-15920,1422319,418,130,0
-566172,286010,281460,1298,824903,808774,1046,130,0
-256,-308,564,0,-8896,16311,0,124,1
347,-664,317,0,-1258,600,-1,124,1
0,-208206,208206,0,-269443,269443,0,124,1
0,0,0,0,0,0,0,124,1
898333,-963987,67602,1948,-1462958,101803,-211,130,0
1034838,-811231,-222309,1298,-1217665,-334528,-420,130,0
109146,130940,-240086,0,169451,-310700,-1,124,1
1085540,-562922,-521970,648,-847946,-785104,-211,130,0
178756,374414,-555121,-1951,1085696,-1599534,417,130,0
1058889,-579172,-477768,1949,-893611,-737344,-420,130,0
-986737,569421,417965,649,939694,688117,1465,130,0
-431,653,-221,1,1237,-420,0,124,1
503118,-478418,-24701,-1,-1377074,-72688,-421,130,0
738,-1413,674,-1,-16328,7793,-1,124,1
139,-50,-88,1,-5853,-10279,1,124,1
898333,-963987,69552,3898,-1463796,104107,207,130,0
131954,-113755,-16251,1948,-1297684,-210521,-212,130,0
857382,149505,-1003638,3249,222878,-1512184,836,130,0
143005,-72803,-68903,1299,-822390,-810869,-210,130,0
-965937,293811,674075,1949,482206,1110414,418,130,0
-304212,-3251,310061,2598,-15711,1422319,417,130,0
156005,-353614,200207,2598,-1629698,914557,-421,130,0
-75403,335412,-258710,1299,1558267,-1203840,627,130,0
-737778,-317212,1060189,5199,-480740,1592411,208,130,0
984136,-889884,-92304,1948,-1340416,-138881,-630,130,0
690975,-482969,-207358,648,-1112510,-480112,-840,130,0
-310062,1054989,-744278,649,1589478,-1121936,1046,130,0
30000,30000,30000,90000,60000,60000,180000,124,1
664,-332,-332,0,-629,-629,0,124,1
372463,-981537,609072,-2,-1617758,1005259,-211,130,0
-658475,-402366,1067339,6498,-614593,1617967,209,130,0
-889234,63702,826180,648,103688,1360106,836,130,0
-293812,1039388,-744928,648,1585079,-1135133,1255,130,0
700076,-439417,-260660,-1,-1012801,-603910,-630,130,0
632,-493,-138,1,-935,-261,1,124,1
-99454,135855,-35752,649,1579005,-425858,1256,130,0
-1066040,423165,647424,4549,641614,980541,1045,130,0
3059,6624,-9683,0,18925,-27666,-1,124,1
-687076,1069940,-382215,649,1612311,-576050,1046,130,0
4823,-4971,148,0,-14354,427,0,124,1
30000,30000,30000,90000,60000,60000,180000,124,1
-531720,-136506,671475,3249,-317980,1546327,208,130,0
-63053,139755,-75403,1299,1631582,-892564,836,130,0
156655,-352964,198907,2598,-1629698,914557,-211,130,0
0,0,0,0,0,0,0,124,1
-655875,555770,102053,1948,1285533,230629,836,130,0
62402,269760,-330863,1299,1253694,-1533341,1255,130,0
974386,-93604,-878833,1949,-143489,-1336855,418,130,0
656,-238,-418,0,-451,-792,0,124,1
-113105,127404,-13001,1298,1492911,-171768,836,130,0
-72153,139755,-66303,1299,1633258,-780705,1046,130,0
454367,-1079691,629873,4549,-1626346,947026,-1,130,0
-90354,137805,-45502,1949,1606864,-547353,1045,130,0
-1018589,188507,833981,3899,282369,1252437,1046,130,0
-520020,-552521,1077090,4549,-842290,1633468,209,130,0
565,-282,-282,1,-8167,-8167,0,124,1
4301,-5332,1030,-1,-15397,2976,-1,124,1
-136506,-407566,544070,-2,-1177237,1569369,-211,130,0
-809281,1030288,-221009,-2,1552402,-334528,1256,130,0
0,1224,-1224,0,14145,-14145,0,124,1
-16507,-51291,67798,0,-82066,108478,1,124,1
0,0,0,0,0,0,0,124,1
-136506,96203,41601,1298,1124868,463772,837,130,0
-1052390,648724,406265,2599,997508,622343,1674,130,0
882083,-995188,115704,2599,-1493331,172605,-420,130,0
306161,1300,-305512,1949,10473,-1419387,-1,130,0
848931,16250,-865183,-2,26393,-1427138,-2,130,0
5587,-2027,-3559,1,-5853,-10279,1,124,1
147555,-1004938,860632,3249,-1511346,1292655,207,130,0
-490119,1082940,-592173,648,1631373,-892564,836,130,0
-563572,324362,239858,648,936761,691050,1046,130,0
-124805,7150,120904,3249,92796,1365761,417,130,0
906133,65652,-968537,3248,96985,-1460025,627,130,0
550,-160,-389,1,-4639,-11243,0,124,1
-216,-344,560,0,-9943,16194,1,124,1
-347,664,-317,0,1258,-600,1,124,1
664,-332,-332,0,-629,-629,0,124,1
-545371,1084240,-536271,2598,1633886,-809612,1046,130,0
-102704,342562,-239209,649,1592620,-1111882,836,130,0
976986,-362714,-616874,-2602,-597836,-1017409,-421,130,0
-1000388,194357,808630,2599,297870,1241963,627,130,0
563,-243,-320,0,-7032,-9251,0,124,1
-312662,-391315,707226,3249,-908065,1629697,-211,130,0
-831,-575,1406,0,-6643,16244,1,124,1
227508,-350364,126104,3248,-1611264,571022,-630,130,0
1075,257,-1333,-1,2976,-15397,-1,124,1
-1144,1291,-147,0,14922,-1707,1,124,1
1414,-707,-707,0,-8167,-8167,0,124,1
912634,-791080,-120905,649,-1305015,-198371,-420,130,0
3325,-5625,2300,0,-16244,6643,-1,124,1
6429,3304,-9733,0,9441,-27810,0,124,1
1396,-506,-889,1,-5853,-10279,1,124,1
169999,-232224,62224,-1,-300525,80525,-1,124,1
325662,-286011,-39652,-1,-1312137,-187060,-630,130,0
65652,75402,-139106,1948,888583,-1630745,1047,130,0
-328913,560971,-231409,649,1625717,-671779,1046,130,0
295,-565,269,-1,-16328,7793,-1,124,1
-536921,-546021,1086190,3248,-825113,1633468,209,130,0
170000,62224,-232224,0,80525,-300525,0,124,1
44851,93603,-136506,1948,1093237,-1597230,417,130,0
-86454,-253510,342562,2598,-1167392,1573139,-421,130,0
640924,441366,-1079691,2599,661305,-1623623,837,130,0
3059,-9683,6624,0,-27666,18925,-1,124,1
-146906,919134,-773529,-1301,1520562,-1277365,1256,130,0
-464118,692275,-226859,1298,1603094,-527453,1255,130,0
-85804,-894434,983486,3248,-1345234,1475525,-211,130,0
-409516,-293812,705926,2598,-680577,1625926,208,130,0
437,-1383,946,0,-15977,10929,-1,124,1
-2955,5654,-2699,0,16328,-7793,1,124,1
109204,880132,-988688,648,1325333,-1489770,1255,130,0
-5226,738,4487,-1,2132,12958,0,124,1
-563,320,243,0,9251,7032,0,124,1
-589573,-493369,1086190,3248,-744466,1631163,-1,130,0
-205,-444,650,1,-842,1231,1,124,1
-82554,978936,-897034,-652,1472383,-1348586,836,130,0
-32101,70613,-38511,1,112982,-61618,1,124,1
-65328,9229,56098,-1,14767,89757,-1,124,1
-521320,450466,70202,-652,1303339,202350,1465,130,0
876882,-958136,83853,2599,-1474479,127778,-630,130,0
1043289,-781980,-259360,1949,-1178494,-390458,-212,130,0
-956186,923684,34451,1949,1390270,48178,1046,130,0
-523270,-465418,989337,649,-768975,1632420,208,130,0
70492,-40050,-30441,1,-64081,-48706,1,124,1
-827482,-196308,1026388,2598,-295985,1539205,628,130,0
-438117,-638974,1081640,4549,-962946,1624041,-211,130,0
-5818,9845,-4026,1,28129,-11504,0,124,1
-241810,-709827,952935,1298,-1172419,1571254,-211,130,0
-170000,232224,-62224,0,300525,-80525,0,124,1
30000,30000,30000,90000,60000,60000,180000,124,1
-484919,-9751,495968,1298,-29955,1429441,627,130,0
-420566,-657825,1080990,2599,-989549,1620271,-1,130,0
-109855,-880133,992587,2599,-1324915,1490188,-211,130,0
526519,-1085541,561621,2599,-1633469,845012,-212,130,0
-599973,-454368,1058889,4548,-703200,1628231,209,130,0
219708,340612,-561622,-1302,986825,-1620272,417,130,0
102053,-137806,38351,2598,-1578377,423134,-630,130,0
70492,-40050,-30441,1,-64081,-48706,1,124,1
314611,-1057590,745577,2598,-1590108,1120259,-631,130,0
-124805,6500,120254,1949,92377,1365971,627,130,0
141313,97786,-239099,0,126546,-309422,-1,124,1
0,0,0,0,0,0,0,124,1
482,-497,14,-1,-14354,427,0,124,1
-64,-77,141,0,-8896,16311,0,124,1
48101,585021,-632474,648,1356964,-1465681,837,130,0
-973087,96203,882733,5849,144117,1337273,1046,130,0
1057589,-750779,-304862,1948,-1128849,-458327,-421,130,0
157955,517419,-674076,1298,1198602,-1560153,1255,130,0
637673,-1082941,448516,3248,-1625718,672826,-211,130,0
213858,135855,-349064,649,639101,-1620900,837,130,0
-53953,-87104,141055,-2,-992901,1619642,-211,130,0
-5639,3204,2435,0,9251,7032,0,124,1
173556,-553821,380914,649,-1596811,1097846,-630,130,0
83,-140,57,0,-16244,6643,-1,124,1
538870,-120905,-419266,-1301,-346468,-1208867,-210,130,0
222115,-190735,-31380,0,-246833,-40610,0,124,1
1010137,-825531,-182007,2599,-1254113,-279647,-211,130,0
918,472,-1390,0,5452,-16060,0,124,1
1043289,-780680,-261310,1299,-1176818,-392762,-211,130,0
638973,-975687,338012,1298,-1608960,558035,-839,130,0
-1054340,707226,349713,2599,1074594,528918,1255,130,0
850881,-1010138,161206,1949,-1520563,242778,-2,130,0
-107905,-25351,135205,1949,-290539,1537320,627,130,0
-541,-860,1402,1,-9943,16194,1,124,1
-141056,69552,72152,648,817990,815686,836,130,0
-214212,12582,201630,0,16283,260933,0,124,1
126754,-120255,-5851,648,-1372466,-81485,-839,130,0
94253,46151,-137156,3248,538973,-1604561,-1,130,0
-558,202,355,-1,5853,10279,-1,124,1
-3999,5464,-1464,1,15777,-4227,1,124,1
-60290,62141,-1850,1,99426,-2961,0,124,1
-141056,69552,71502,-2,819666,814010,1045,130,0
-375715,1056939,-681876,-652,1611682,-1038147,1046,130,0
-420566,700726,-278211,1949,1622994,-647481,1046,130,0
-1006238,144305,864532,2599,214500,1295169,627,130,0
839831,139755,-978287,1299,213662,-1508623,627,130,0
-31852,133905,-102054,-1,1564342,-1190015,627,130,0
949035,-17551,-928885,2599,-29536,-1399488,-2,130,0
-1032889,811880,222958,1949,1220178,331385,1255,130,0
30000,30000,30000,90000,60000,60000,180000,124,1
457617,599322,-1056290,649,922517,-1628232,836,130,0
-564222,323712,240509,-1,934876,693354,1255,130,0
0,0,0,0,0,0,0,124,1
-437,-946,1383,0,-10929,15977,1,124,1
1073840,-569422,-503119,1299,-865961,-766461,-211,130,0
601272,455667,-1056290,649,699848,-1627603,418,130,0
6429,3304,-9733,0,9441,-27810,0,124,1
30000,30000,30000,90000,60000,60000,180000,124,1
455667,530419,-988038,-1952,876852,-1631583,627,130,0
709176,-1040039,332162,1299,-1599324,510903,-420,130,0
-893134,-86454,982836,3248,-131340,1475525,417,130,0
848281,-1011438,164456,1299,-1522029,247177,-2,130,0
1548,-9241,7693,0,-26405,21981,0,124,1
436166,643524,-1078391,1299,967554,-1622995,1046,130,0
-971787,94903,884033,7149,141184,1339158,1255,130,0
75402,65652,-138456,2598,773792,-1632002,628,130,0
-635074,1080340,-444617,649,1625508,-669894,1046,130,0
942535,-212558,-731278,-1301,-351915,-1205097,-211,130,0
-81904,139105,-55903,1298,1625298,-667799,1046,130,0
1036138,-766379,-269111,648,-1163412,-411405,-211,130,0
22750,928884,-950336,1298,1397811,-1430908,1047,130,0
8820,-8302,-518,0,-23721,-1480,0,124,1
443,4661,-5105,-1,13461,-14742,0,124,1
30000,30000,30000,90000,60000,60000,180000,124,1
-664,332,332,0,629,629,0,124,1
-1025089,823580,204107,2598,1239240,302897,1465,130,0
11050,-128055,118954,1949,-1471546,1350260,-421,130,0
123504,-993888,874282,3898,-1497102,1315069,208,130,0
174,-553,378,-1,-15977,10929,-1,124,1
-313962,-390015,707226,3249,-904085,1630116,-2,130,0
-205,-444,650,1,-842,1231,1,124,1
-566,-17,584,1,-32,1106,1,124,1
-57206,-7391,64597,0,-11826,103355,0,124,1
240509,710476,-951636,-651,1174094,-1570627,1046,130,0
-685776,1070590,-383515,1299,1612730,-579611,1047,130,0
23400,-317862,297061,2599,-1463167,1360944,-420,130,0
431,221,-653,-1,420,-1237,0,124,1
260009,304211,-565522,-1302,881670,-1631164,627,130,0
-766379,1017288,-248960,1949,1568531,-387315,1256,130,0
-118955,123504,-2601,1948,1439286,-49855,1255,130,0
-351664,1041339,-689026,649,1606027,-1063493,1256,130,0
35101,101403,-133906,2598,1179959,-1567694,836,130,0
-134556,29901,107254,2599,345420,1209914,837,130,0
-139756,79302,62402,1948,928801,699848,1465,130,0
30000,30000,30000,90000,60000,60000,180000,124,1
776,8158,-8935,-1,23309,-25528,0,124,1
668875,-140406,-529120,-651,-322798,-1225206,-211,130,0
-503119,1058239,-555121,-1,1633468,-855696,1256,130,0
237456,-151298,-86157,1,-195798,-111497,1,124,1
-47452,-464118,513519,1949,-1339997,1479086,-211,130,0
-39652,507018,-468018,-652,1469869,-1352356,836,130,0
-61753,639623,-577222,648,1482019,-1336017,837,130,0
-1016639,771578,247659,2598,1188129,377679,1465,130,0
-295,-269,565,1,-7793,16328,1,124,1
1320,-5423,4103,0,-15661,11848,0,124,1
-5818,9845,-4026,1,28129,-11504,0,124,1
354263,-159906,-193058,1299,-732945,-897591,-1,130,0
-73,141,-67,1,16328,-7793,1,124,1
-525870,1071890,-546021,-1,1633886,-831817,1464,130,0
408215,295111,-702677,649,684137,-1626137,836,130,0
-32101,70613,-38511,1,112982,-61618,1,124,1
-934736,32501,904833,2598,47759,1390060,626,130,0
657824,420565,-1075791,2598,630722,-1619853,627,130,0
998437,-191108,-806031,1298,-296823,-1242174,208,130,0
-542121,662374,-118305,1948,1533549,-278390,1046,130,0
60290,1850,-62141,-1,2961,-99426,0,124,1
-214212,12582,201630,0,16283,260933,0,124,1
182006,-354264,174856,2598,-1633887,801861,-629,130,0
236608,713076,-950986,-1302,1177027,-1569160,837,130,0
-389365,-594123,982836,-652,-980961,1621528,-210,130,0
137,-40,-97,0,-4639,-11243,0,124,1
-601273,-454368,1059539,3898,-703619,1628440,418,130,0
-182813,226626,-43812,1,293281,-56698,1,124,1
-99,136,-36,1,15777,-4227,1,124,1
662374,401065,-1063440,-1,609565,-1616711,836,130,0
1041989,-354914,-687726,-651,-547772,-1058466,-211,130,0
-164457,-187858,355563,3248,-868893,1632211,-1,130,0
826180,-992588,167706,1298,-1526009,257232,-420,130,0
-912635,790429,122204,-2,1305643,198370,1255,130,0
-100754,-555121,658474,2599,-1283021,1517001,-1,130,0
222115,-190735,-31380,0,-246833,-40610,0,124,1
798879,-908085,111154,1948,-1497311,183498,-210,130,0
-36946,70686,-33740,0,113098,-53984,1,124,1
104003,553170,-656525,648,1280297,-1518677,1256,130,0
313961,-1057590,746877,3248,-1589898,1120678,-421,130,0
796929,-909385,114404,1948,-1499615,188944,-210,130,0
-45502,-913935,962686,3249,-1378331,1448503,-2,130,0
984786,-888584,-94254,1948,-1338531,-142023,-420,130,0
-1040039,251559,791729,3249,377469,1187710,836,130,0
-70492,30441,40050,-1,48706,64081,-1,124,1
976336,-631174,-345163,-1,-1041499,-569138,-421,130,0
-140,80,60,0,9251,7032,0,124,1
-37609,-186838,224447,0,-241791,290462,1,124,1
30000,30000,30000,90000,60000,60000,180000,124,1
172256,-553171,382214,1299,-1595973,1100778,-840,130,0
-705927,394564,312661,1298,911625,718700,1255,130,0
1076440,-410816,-663675,1949,-621087,-997509,-1,130,0
8440,-8699,259,0,-24856,740,0,124,1
101403,35101,-134556,1948,417269,-1575654,627,130,0
-120,124,-3,1,14354,-427,0,124,1
709826,-1040689,331512,649,-1599115,509856,-630,130,0
-632,138,493,-1,261,935,-1,124,1
-37609,-186838,224447,0,-241791,290462,1,124,1
-128705,-865833,999087,4549,-1306063,1502966,208,130,0
879482,-834632,-44852,-2,-1376446,-73735,-421,130,0
9777,-3547,-6229,1,-10136,-17799,1,124,1
171606,842431,-1014038,-1,1267938,-1525800,627,130,0
986086,-434867,-554471,-3252,-716816,-912673,-420,130,0
-903534,-65003,973086,4549,-100128,1461909,627,130,0
0,0,0,0,0,0,0,124,1
-224259,347113,-122205,649,1611473,-571861,1046,130,0
-1026389,278860,750128,2599,426905,1152099,836,130,0
916534,-137806,-780030,-1302,-228745,-1285744,207,130,0
-9899,4949,4949,-1,14142,14142,0,124,1
-1062790,721527,345162,3899,1084021,516978,1256,130,0
2164,-5608,3443,-1,-16194,9943,-1,124,1
-494669,-589573,1087490,3248,-887327,1631373,-1,130,0
298361,-966587,670175,1949,-1594507,1104968,-421,130,0
457,-516,59,0,-14922,1707,-1,124,1
-166407,1012087,-845682,-2,1523285,-1272547,1046,130,0
93603,435516,-528470,649,1261025,-1529570,627,130,0
-137156,96853,40951,648,1126544,461468,837,130,0
521969,-452417,-68253,1299,-1304806,-198790,-420,130,0
642,770,-1412,0,8896,-16311,0,124,1
711776,-1040039,330212,1949,-1598696,507342,-630,130,0
482,14,-497,-1,427,-14354,0,124,1
880132,-995838,117654,1948,-1494588,175747,-211,130,0
-614924,1080340,-464118,1298,1628650,-700058,1465,130,0
-73,-67,141,1,-7793,16328,1,124,1
437,946,-1383,0,10929,-15977,-1,124,1
-1064740,356213,713076,4549,533107,1070824,1046,130,0
43,-138,94,-1,-15977,10929,-1,124,1
-349714,131954,219708,1948,614802,1003164,627,130,0
30000,30000,30000,90000,60000,60000,180000,124,1
1068640,-705277,-363364,-1,-1059304,-547562,-630,130,0
-956186,875582,81903,1299,1349841,122960,1464,130,0
-820331,991287,-168357,2599,1527893,-262051,1255,130,0
-796930,906133,-109855,-652,1497729,-182870,1255,130,0
63003,-59302,-3700,1,-94884,-5921,0,124,1
-2568,5649,-3080,1,16311,-8896,0,124,1
-1080341,635723,446566,1948,956242,669474,1255,130,0
-364664,555120,-189808,648,1607912,-552589,837,130,0
-724778,-337363,1065389,3248,-509857,1598486,-211,130,0
-347,664,-317,0,1258,-600,1,124,1
-633124,587622,46151,649,1361572,101594,1046,130,0
0,0,0,0,0,0,0,124,1
-253510,-87104,341912,1298,-397789,1570835,208,130,0
986736,-431617,-556421,-1302,-713255,-915815,-420,130,0
301611,728677,-1030939,-651,1122773,-1588432,1046,130,0
30000,30000,30000,90000,60000,60000,180000,124,1
614,-86,-527,1,-164,-998,0,124,1
789779,220358,-1006888,3249,336413,-1551984,417,130,0
109204,-133906,26650,1948,-1541301,301221,-421,130,0
451116,-1080341,632473,3248,-1625927,952262,-211,130,0
1006237,-865183,-139106,1948,-1297684,-210521,-212,130,0
387414,594772,-982187,-1,981379,-1621319,418,130,0
27059,-70105,43045,-1,-112169,68873,-1,124,1
-980237,364013,617523,1299,598672,1016989,626,130,0
635723,-590873,-43552,1298,-1360107,-103899,-630,130,0
-259360,-305512,565521,649,-883137,1631582,208,130,0
9145,-7853,-1292,0,-22439,-3691,1,124,1
35751,286010,-320463,1298,1328266,-1487047,1046,130,0
-240416,120208,120208,0,155563,155563,0,124,1
0,0,0,0,0,0,0,124,1
507018,-1062140,556420,1298,-1633259,855695,-421,130,0
565,-282,-282,1,-8167,-8167,0,124,1
-831,-575,1406,0,-6643,16244,1,124,1
30000,30000,30000,90000,60000,60000,180000,124,1
625973,-31202,-596723,-1952,-68079,-1378959,208,130,0
-989338,436166,553820,648,717862,912044,836,130,0
87753,-527820,442016,1949,-1522239,1274641,-2,130,0
-41562,-28760,70323,1,-46016,112517,1,124,1
-505,626,-121,0,1186,-229,0,124,1
-542771,662374,-117655,1948,1533130,-277133,1046,130,0
-400,-146,546,0,-4227,15777,0,124,1
-606473,-471918,1083590,5199,-713464,1629278,208,130,0
65328,-9229,-56098,1,-14767,-89757,1,124,1
505718,-35102,-472568,-1952,-98662,-1362411,-211,130,0
-617524,1080990,-461518,1948,1628440,-696916,1255,130,0
-705927,394564,313961,2598,909530,720795,1046,130,0
-141,70,70,-1,8167,8167,0,124,1
-332813,266509,68252,1948,1234422,309600,836,130,0
-838532,-175507,1018588,4549,-265402,1528312,627,130,0
84503,811230,-896384,-651,1339787,-1479087,627,130,0
1075790,-654575,-421216,-1,-986617,-634284,-421,130,0
-3251,-938636,945785,3898,-1411427,1418339,-211,130,0
301,-663,362,0,-1256,685,0,124,1
-87104,-894434,984136,2598,-1344815,1475525,-1,130,0
-966587,913934,53301,648,1374978,77295,1465,130,0
-662,286,376,0,541,712,-1,124,1
-117655,-863233,986086,5198,-1315070,1496891,-2,130,0
65002,-143006,78002,-2,-1631583,890258,-630,130,0
204988,-211281,6293,0,-273423,8144,0,124,1
690325,-1073191,386114,3248,-1612731,579401,-421,130,0
67602,-643525,578521,2598,-1484533,1332455,-1,130,0
295,-565,269,-1,-16328,7793,-1,124,1
1012087,-163807,-846332,1948,-248435,-1273385,418,130,0
0,0,0,0,0,0,0,124,1
-69840,44499,25340,-1,71199,40544,-1,124,1
349713,-229459,-118955,1299,-1052601,-555941,-840,130,0
-807331,1030288,-222309,648,1553030,-336623,1255,130,0
-1306,184,1121,-1,2132,12958,0,124,1
-70710,35355,35355,0,56568,56568,-1,124,1
30000,30000,30000,90000,60000,60000,180000,124,1
912634,-791730,-119605,1299,-1306482,-195857,-211,130,0
-375065,1056939,-681876,-2,1611473,-1038776,1046,130,0
-577222,1058239,-479718,1299,1631792,-741534,1255,130,0
34451,-135856,104653,3248,-1564761,1188757,-629,130,0
-61103,-271711,334762,1948,-1249715,1535853,-2,130,0
1409,-608,-801,0,-7032,-9251,0,124,1
-334113,1061489,-726728,648,1597857,-1094076,1256,130,0
87103,808630,-896384,-651,1337902,-1480553,837,130,0
-138456,-840482,982186,3248,-1295799,1509041,-630,130,0
4823,148,-4971,0,427,-14354,0,124,1
-1344,294,1050,0,3396,12138,0,124,1
-776,-8158,8935,1,-23309,25528,0,124,1
-650675,-319162,972436,2599,-529129,1602884,-2,130,0
936035,-7801,-924335,3899,-14664,-1406610,626,130,0
-102054,-553821,659124,3249,-1280717,1518258,-420,130,0
128704,-542121,412765,-652,-1563086,1193156,-421,130,0
139755,-41602,-96204,1949,-466287,-1122565,-212,130,0
-731928,1057589,-324363,1298,1594925,-490795,1046,130,0
-137156,40301,100103,3248,465448,1123192,418,130,0
1052389,-646775,-403666,1948,-997090,-622134,-629,130,0
30000,30000,30000,90000,60000,60000,180000,124,1
-365314,-689026,1060839,6499,-1050925,1608750,208,130,0
140,-80,-60,0,-9251,-7032,0,124,1
696826,-959436,263909,1299,-1581519,436541,-420,130,0
300311,265209,-564872,648,767507,-1632002,417,130,0
93603,436166,-528470,1299,1262910,-1528523,1045,130,0
63052,-969187,909384,3249,-1459397,1365552,-211,130,0
247659,-344513,99453,2599,-1585918,452670,-630,130,0
804080,97503,-902234,-651,159408,-1487047,417,130,0
-194500,-25130,219631,1,-32521,284228,0,124,1
-882084,-106604,993237,4549,-161713,1488512,627,130,0
522,-73,-448,1,-2132,-12958,0,124,1
1027038,-822931,-202158,1949,-1237565,-304783,-420,130,0
-1054340,705926,352963,4549,1071033,533107,1045,130,0
0,0,0,0,0,0,0,124,1
-297062,313311,-13001,3248,1449969,-72688,1045,130,0
-253510,562921,-309412,-1,1631373,-896334,1465,130,0
564871,-247010,-317862,-1,-711789,-917072,-211,130,0
75402,-143656,68902,648,-1633469,782380,-630,130,0
-839182,874282,-35752,-652,1444314,-60329,1046,130,0
116354,13650,-127405,2599,169044,-1491027,418,130,0
-534971,-546671,1086190,4548,-826370,1633468,209,130,0
-1040039,249609,793029,2599,375375,1189176,837,130,0
-1027039,279510,749478,1949,428581,1150842,836,130,0
-261310,-437467,701376,2599,-1012382,1616291,-1,130,0
0,0,0,0,0,0,0,124,1
1344,-1050,-294,0,-12138,-3396,0,124,1
141705,-52652,-86454,2599,-591761,-1022437,-211,130,0
-1045890,273010,776779,3899,408052,1165924,836,130,0
9868,-4261,-5607,0,-12176,-16020,1,124,1
11,-127,116,0,-14742,13461,0,124,1
330862,-707227,380264,3899,-1632631,873710,-630,130,0
-505,-121,626,0,-229,1186,0,124,1
30000,30000,30000,90000,60000,60000,180000,124,1
529119,529769,-1059540,-652,815686,-1632840,836,130,0
9750,-616874,609722,2598,-1424205,1404723,-420,130,0
204988,6293,-211281,0,8144,-273423,0,124,1
-614,86,527,-1,164,998,0,124,1
495968,590222,-1084891,1299,885859,-1630955,836,130,0
91,47,-139,-1,5452,-16060,0,124,1
-656,238,418,0,451,792,0,124,1
538870,-121555,-419266,-1951,-348354,-1207401,208,130,0
-291211,563571,-272361,-1,1633468,-788246,837,130,0
-69840,25340,44499,-1,40544,71199,-1,124,1
-6429,9733,-3304,0,27810,-9441,0,124,1
-460218,-617524,1082290,4548,-933411,1627812,-1,130,0
1409,-608,-801,0,-7032,-9251,0,124,1
9868,-4261,-5607,0,-12176,-16020,1,124,1
84503,-980887,898333,1949,-1473431,1347956,-1,130,0
-43,138,-94,1,15977,-10929,1,124,1
755328,-1055640,302261,1949,-1586547,454555,-631,130,0
-666925,-378315,1049139,3899,-584010,1612730,-1,130,0
319161,-26651,-292511,-1,-115210,-1353404,-420,130,0
-233773,68281,165491,-1,88364,214165,-1,124,1
378964,-1061490,685775,3249,-1611474,1039822,-2,130,0
347,-664,317,0,-1258,600,-1,124,1
-141706,-210608,352963,649,-970697,1622784,-421,130,0
854782,152105,-1004288,2599,225811,-1513441,627,130,0
16507,51291,-67798,0,82066,-108478,-1,124,1
-363364,555770,-192408,-2,1608959,-557826,1046,130,0
9625,-6814,-2811,0,-19469,-8033,0,124,1
228158,-694227,468667,2598,-1602048,1078155,-631,130,0
-353614,1041339,-687726,-1,1606446,-1060770,837,130,0
-70492,40050,30441,-1,64081,48706,-1,124,1
-31202,-103354,137155,2599,-1185197,1566017,-630,130,0
-656,418,238,0,792,451,0,124,1
-431,-221,653,1,-420,1237,0,124,1
-5040,296,4744,0,854,13698,-1,124,1
646124,-1053690,410165,2599,-1620481,629465,-839,130,0
0,0,0,0,0,0,0,124,1
958135,-875583,-81254,1298,-1348376,-124846,-630,130,0
-120,124,-3,1,14354,-427,0,124,1
299011,265859,-564872,-2,770440,-1632212,627,130,0
-1037439,713076,326312,1949,1097846,499173,1256,130,0
30000,30000,30000,90000,60000,60000,180000,124,1
776,-8935,8158,-1,-25528,23309,0,124,1
-105954,-881434,990637,3249,-1327848,1488093,-421,130,0
-542771,662374,-117005,2598,1532921,-276504,1047,130,0
-1075,1333,-257,1,15397,-2976,1,124,1
521319,553820,-1073191,1948,841451,-1632631,1045,130,0
987386,-432917,-555121,-652,-714931,-914349,-421,130,0
-128705,111154,19500,1949,1297054,211986,1046,130,0
-731928,-299662,1033538,1948,-463145,1588012,208,130,0
-90354,137805,-46152,1299,1607074,-547562,1046,130,0
119604,-664325,546020,1299,-1531874,1257464,-420,130,0
843731,135855,-976987,2599,207168,-1506109,627,130,0
204757,-353614,152105,3248,-1627813,693145,-420,130,0
-32502,133905,-101404,-1,1565598,-1187082,1255,130,0
-2164,5608,-3443,1,16194,-9943,1,124,1
-1058240,752078,305511,-651,1130733,456231,1255,130,0
247659,-344513,98803,1949,-1585080,448481,-629,130,0
-9145,7853,1292,0,22439,3691,-1,124,1
0,0,0,0,0,0,0,124,1
365313,-558371,193057,-1,-1608960,557825,-839,130,0
9868,-4261,-5607,0,-12176,-16020,1,124,1
-182813,226626,-43812,1,293281,-56698,1,124,1
-323713,284060,41601,1948,1314650,183079,1046,130,0
-237909,-711777,952285,2599,-1175980,1569997,-2,130,0
30000,30000,30000,90000,60000,60000,180000,124,1
30000,30000,30000,90000,60000,60000,180000,124,1
-5639,2435,3204,0,7032,9251,0,124,1
24050,-133255,111154,1949,-1525381,1269404,-421,130,0
-340613,-722178,1066689,3898,-1088002,1599114,-630,130,0
397814,-548621,151455,648,-1581310,434865,-630,130,0
-501819,475817,25350,-652,1376863,73315,836,130,0
978936,-878183,-99454,1299,-1332666,-151868,-2,130,0
-156656,-518720,676675,1299,-1198603,1560152,-211,130,0
-430,533,-103,0,15397,-2976,1,124,1
109146,-240086,130940,0,-310700,169451,-1,124,1
354263,-158606,-193708,1949,-727080,-903247,-421,130,0
-375065,705276,-328263,1948,1633049,-763109,1256,130,0
-72803,139755,-65653,1299,1633468,-780915,1256,130,0
1084240,-510920,-572022,1298,-771698,-860514,208,130,0
399114,-548621,150155,648,-1580681,432142,-629,130,0
30000,30000,30000,90000,60000,60000,180000,124,1
233358,-1035489,804730,2599,-1556383,1208028,-212,130,0
784579,260659,-1041990,3248,388781,-1567694,837,130,0
-830082,-191758,1025738,3898,-290330,1537320,627,130,0
-456968,-599973,1058889,1948,-925451,1628440,-2,130,0
-1025739,278210,750128,2599,425857,1152937,836,130,0
-219059,-341263,562271,1949,-987455,1620480,-211,130,0
-295,-269,565,1,-7793,16328,1,124,1
-133906,29901,107254,3249,346467,1209285,836,130,0
-1005588,145605,863232,3249,217013,1293493,417,130,0
475167,-1084241,612322,3248,-1629279,919375,-211,130,0
-637024,1079690,-442017,649,1625089,-666124,1046,130,0
-139106,88403,52001,1298,1030396,582543,627,130,0
-1084891,492068,596072,3249,738391,892772,1046,130,0
34451,-135856,104653,3248,-1564761,1188966,-420,130,0
30000,30000,30000,90000,60000,60000,180000,124,1
30000,30000,30000,90000,60000,60000,180000,124,1
-19501,315261,-293161,2599,1461281,-1362830,1046,130,0
936035,-9101,-923685,3249,-16549,-1405562,836,130,0
-8451,615573,-605823,1299,1425042,-1403886,627,130,0
1000387,-196308,-802781,1298,-303526,-1237775,-1,130,0
-316562,-653275,970486,649,-1080251,1601209,-420,130,0
-1059540,313311,748178,1949,468171,1121307,837,130,0
926934,29251,-954236,1949,41266,-1434679,-1,130,0
30000,30000,30000,90000,60000,60000,180000,124,1
1044589,-271711,-772229,649,-410986,-1163412,-2,130,0
-9145,7853,1292,0,22439,3691,-1,124,1
37609,186838,-224447,0,241791,-290462,-1,124,1
-978287,83853,898983,4549,124426,1348375,836,130,0
-978287,81253,900283,3249,121075,1350470,1046,130,0
-49999,68301,-18301,1,109282,-29282,1,124,1
-3673,5562,-1888,1,16060,-5452,0,124,1
-637024,972436,-336713,-1301,1608959,-556779,1255,130,0
-202808,-810581,1018588,5199,-1233376,1544651,417,130,0
-20801,-111155,133905,1949,-1267729,1525799,-420,130,0
210607,-1025739,819030,3898,-1545490,1231908,-2,130,0
-403666,-143006,546020,-652,-411824,1574815,-211,130,0
60290,-62141,1850,-1,-99426,2961,0,124,1
-969837,113104,859332,2599,171767,1320934,836,130,0
-676676,-393265,1074490,4549,-596369,1615243,417,130,0
-52,599,-547,0,1136,-1037,1,124,1
1306,-1121,-184,1,-12958,-2132,0,124,1
-518070,-553821,1077090,5199,-844175,1633258,208,130,0
-315912,-653925,970486,649,-1080670,1600790,-630,130,0
23400,-131955,111154,2599,-1524543,1270870,-212,130,0
-212558,-139756,352963,649,-637845,1620899,-421,130,0
466717,-694877,230758,2598,-1603095,529337,-211,130,0
-52652,138455,-85804,-1,1619642,-995834,836,130,0
30000,30000,30000,90000,60000,60000,180000,124,1
306161,1950,-306162,1949,14453,-1421482,208,130,0
107904,-966587,861932,3249,-1490189,1325333,-211,130,0
-1414,707,707,0,8167,8167,0,124,1
-118955,122854,-1951,1948,1436144,-43152,1045,130,0
1396,-889,-506,1,-10279,-5853,1,124,1
776,-8935,8158,-1,-25528,23309,0,124,1
30000,30000,30000,90000,60000,60000,180000,124,1
23400,-317862,297061,2599,-1462329,1361781,-211,130,0
0,0,0,0,0,0,0,124,1
75402,65652,-139106,1948,774420,-1632421,627,130,0
468667,-694227,228158,2598,-1602257,524310,-629,130,0
458267,598672,-1056940,-1,921470,-1628232,836,130,0
261309,436816,-698127,-2,1012590,-1615873,207,130,0
-27059,-43045,70105,1,-68873,112169,1,124,1
537,69,-607,-1,131,-1149,0,124,1
306811,1300,-306162,1949,10473,-1419597,-2,130,0
-546671,1083590,-536271,648,1633886,-808984,1045,130,0
-948386,20800,932134,4548,27650,1400743,836,130,0
8450,300961,-307462,1949,1398439,-1430071,1045,130,0
-7801,614923,-606473,649,1424414,-1404724,1465,130,0
-253510,562921,-310062,-651,1631373,-897381,1256,130,0
132,410,-542,0,11848,-15661,0,124,1
-254,658,-404,0,1247,-766,0,124,1
354263,-159906,-193708,649,-730432,-900314,-630,130,0
273010,57202,-330213,-1,273152,-1530617,627,130,0
-510920,988037,-478418,-1301,1633677,-789503,1046,130,0
1005587,-175507,-828132,1948,-267707,-1261236,207,130,0
-254,658,-404,0,1247,-766,0,124,1
-332163,1060839,-728028,648,1597229,-1095962,1046,130,0
-32502,-102704,137805,2599,-1181217,1567693,-211,130,0
30000,30000,30000,90000,60000,60000,180000,124,1
0,0,0,0,0,0,0,124,1
-1080991,633773,447866,648,954148,671569,1046,130,0
1033538,-260660,-771579,1299,-396532,-1173466,209,130,0
-1075791,655224,424465,3898,984940,636796,1464,130,0
1018588,-769629,-246360,2599,-1184778,-381869,-839,130,0
-3901,-488169,493368,1298,-1407657,1421900,-2,130,0
130654,-542771,412115,-2,-1564343,1189595,-421,130,0
0,-4898,4898,0,-14145,14145,0,124,1
289910,750778,-1038739,1949,1142673,-1581729,1046,130,0
1019238,-185257,-832032,1949,-281532,-1252438,-2,130,0
1035488,-228809,-804731,1948,-345211,-1209705,209,130,0
370513,183306,-555771,-1952,533526,-1603304,-1,130,0
-470618,1080990,-609723,649,1629488,-918538,1466,130,0
647424,325012,-971787,649,533526,-1603095,417,130,0
-390,-270,661,1,-511,1251,1,124,1
0,0,0,0,0,0,0,124,1
41562,28760,-70323,-1,46016,-112517,-1,124,1
-1144,-147,1291,0,-1707,14922,1,124,1
-618174,1080340,-460868,1298,1628021,-695659,836,130,0
-567472,-83854,651324,-2,-193344,1501290,836,130,0
-457,516,-59,0,14922,-1707,1,124,1
-7000,-2562,9562,0,-7320,27320,0,124,1
109146,-240086,130940,0,-310700,169451,-1,124,1
-918485,138455,781329,1299,227906,1287000,627,130,0
1084240,-617524,-464768,1948,-929221,-699011,-420,130,0
-626624,29901,600622,3899,63470,1381681,417,130,0
92003,146356,-238359,0,189402,-308465,0,124,1
2568,-5649,3080,-1,-16311,8896,0,124,1
-668226,-376365,1048489,3898,-582125,1612520,-211,130,0
563,-320,-243,0,-9251,-7032,0,124,1
-337363,79952,260009,2598,371604,1191690,627,130,0
-1084891,473217,614923,3249,710112,918956,627,130,0
85153,-142356,60452,3249,-1625718,671150,-839,130,0
813830,-1033539,221658,1949,-1551774,332433,-629,130,0
-65328,9229,56098,-1,14767,89757,-1,124,1
-521970,1082290,-559671,649,1633468,-844385,1256,130,0
-260660,-304212,565521,649,-880833,1631792,-1,130,0
173556,-554471,380914,-1,-1596392,1098893,-421,130,0
490768,-1086841,598022,1949,-1631374,896543,-420,130,0
-664,332,332,0,629,629,0,124,1
0,0,0,0,0,0,0,124,1
-1748,5533,-3785,0,15977,-10929,1,124,1
103,516,-620,-1,978,-1175,-1,124,1
155,-637,482,0,-1206,912,-1,124,1
-541,1402,-860,1,16194,-9943,1,124,1
1012737,-165757,-845032,1948,-251158,-1271919,-2,130,0
101403,35751,-135206,1948,422506,-1577330,208,130,0
30000,30000,30000,90000,60000,60000,180000,124,1
-352964,157955,195657,648,732735,898218,1046,130,0
0,0,0,0,0,0,0,124,1
437,-1383,946,0,-15977,10929,-1,124,1
284710,-326963,44201,1948,-1502758,196066,-211,130,0
-222309,945135,-723478,-652,1562666,-1193785,1046,130,0
-655875,555120,102703,1948,1284486,232305,1046,130,0
943185,-215159,-729328,-1302,-356314,-1202164,-211,130,0
662,-376,-286,0,-712,-541,1,124,1
-1409,608,801,0,7032,9251,0,124,1
1076440,-412116,-663025,1299,-621925,-997090,-420,130,0
191107,162506,-351664,1949,757662,-1631583,627,130,0
-785230,-239859,1029638,4549,-367625,1562247,627,130,0
856082,150805,-1003638,3249,223716,-1512812,627,130,0
632,-493,-138,1,-935,-261,1,124,1
-118955,-3901,125454,2598,-36658,1432374,418,130,0
-420566,700726,-278211,1949,1622994,-647900,1046,130,0
1548,7693,-9241,0,21981,-26405,0,124,1
-390,-270,661,1,-511,1251,1,124,1
5547,58274,-63822,-1,93239,-102115,0,124,1
373764,-982187,609072,649,-1617968,1004421,-211,130,0
390,-661,270,-1,-1251,511,-1,124,1
-67249,52548,14701,0,84077,23522,0,124,1
-120905,993237,-871033,1299,1497520,-1313394,1046,130,0
5379,-4203,-1176,0,-12138,-3396,0,124,1
841131,139755,-978937,1949,213243,-1508623,418,130,0
-338013,78652,260009,648,369509,1193156,627,130,0
340612,724127,-1064090,649,1087372,-1599115,417,130,0
-9625,6814,2811,0,19469,8033,0,124,1
143005,-63053,-78003,1949,-710322,-918329,-211,130,0
8820,-8302,-518,0,-23721,-1480,0,124,1
-106604,131304,-25351,-651,1542137,-303526,1465,130,0
-939286,0,943835,4549,-2724,1415825,626,130,0
828781,-1027039,200857,2599,-1541091,300174,-211,130,0
945785,-936036,-6501,3248,-1409752,-10474,-421,130,0
939935,-741028,-199558,-651,-1222902,-326778,-630,130,0
-454368,516769,-63053,-652,1498358,-184546,1256,130,0
934084,-5851,-925635,2598,-10893,-1408704,208,130,0
-4494,-5391,9885,0,-15404,28245,1,124,1
-1004938,861932,143655,649,1297054,211567,627,130,0
-409516,-294462,705276,1298,-680787,1626136,208,130,0
-233773,165491,68281,-1,214165,88364,-1,124,1
-129355,17550,114404,2599,215128,1294960,1046,130,0
67249,-52548,-14701,0,-84077,-23522,0,124,1
-1012738,168356,848281,3899,251367,1271918,418,130,0
-336063,-225559,562921,1299,-651670,1622784,-211,130,0
0,0,0,0,0,0,0,124,1
-827482,-193708,1026388,5198,-292843,1538157,627,130,0
-904184,-62403,972436,5849,-97405,1460862,837,130,0
117004,229458,-345163,1299,1069567,-1603723,418,130,0
30000,30000,30000,90000,60000,60000,180000,124,1
-317862,23400,295761,1299,110392,1355916,418,130,0
1017288,-770929,-245060,1299,-1186873,-378937,-631,130,0
-1056290,434216,625323,3249,666542,958547,1047,130,0
602572,-1073841,474517,3248,-1630326,719748,-210,130,0
30000,30000,30000,90000,60000,60000,180000,124,1
-311362,298361,14300,1299,1385033,58442,1465,130,0
-513520,-570722,1086840,2598,-860724,1632420,-211,130,0
-1548,-7693,9241,0,-21981,26405,0,124,1
30000,30000,30000,90000,60000,60000,180000,124,1
506368,-34452,-472568,-652,-96358,-1363877,-211,130,0
18862,-216996,198133,-1,-280818,256407,-1,124,1
824880,-992588,169656,1948,-1527056,260165,-420,130,0
-1017289,770928,248309,1948,1187500,378726,1465,130,0
-504419,1058889,-553171,1299,1633468,-853602,1046,130,0
419915,659774,-1076441,3248,989548,-1620062,-2,130,0
690325,-482319,-207358,648,-1111463,-481159,-630,130,0
65328,-56098,-9229,1,-89757,-14767,1,124,1
1074490,-391315,-681226,1949,-589876,-1024112,-211,130,0
-114,-14,129,1,-1707,14922,1,124,1
436166,641574,-1077741,-1,966088,-1623204,628,130,0
-759229,-171607,931484,648,-284883,1535434,627,130,0
37701,-954886,921734,4549,-1440754,1387547,208,130,0
-363364,555120,-192408,-652,1608959,-557617,836,130,0
-1040039,250259,792379,2599,375584,1188966,836,130,0
-334763,-226859,562921,1299,-655441,1623413,208,130,0
121554,-126105,5850,1299,-1436983,45246,-629,130,0
10400,-617524,609072,1948,-1425462,1403467,-629,130,0
30000,30000,30000,90000,60000,60000,180000,124,1
114,14,-129,-1,1707,-14922,-1,124,1
-447217,1077740,-628574,1949,1626345,-949121,1046,130,0
1078390,-430967,-645475,1948,-651251,-971535,-211,130,0
-484269,-12351,497268,648,-35401,1431955,209,130,0
625973,-30552,-596723,-1302,-67660,-1379378,-211,130,0
-739728,-313962,1058889,5199,-475713,1591364,418,130,0
662,-286,-376,0,-541,-712,1,124,1
166406,-1014038,848931,1299,-1522867,1273384,-2,130,0
1041989,-354914,-687076,-1,-547981,-1058466,-420,130,0
-105954,-881434,990637,3249,-1327429,1488093,-212,130,0
0,0,0,0,0,0,0,124,1
30000,30000,30000,90000,60000,60000,180000,124,1
88,439,-528,-1,12694,-15249,0,124,1
-140406,69552,72152,1298,816943,816734,1046,130,0
30000,30000,30000,90000,60000,60000,180000,124,1
473217,-1083591,614273,3899,-1629070,922727,-211,130,0
-32502,-103354,137805,1949,-1181636,1567484,-1,130,0
-74103,335412,-259360,1949,1557219,-1205935,836,130,0
-783280,-257410,1045239,4549,-388782,1568322,418,130,0
-89054,-893134,984786,2598,-1343139,1476782,-211,130,0
67249,-14701,-52548,0,-23522,-84077,0,124,1
104653,-345163,243109,2599,-1591365,1116279,-840,130,0
-791080,1037438,-245060,1298,1563713,-371186,1465,130,0
-1044590,357513,689675,2598,548190,1058674,836,130,0
-310712,299011,13650,1949,1387128,54462,1465,130,0
-1008838,824230,189807,5199,1251389,284463,1464,130,0
5379,-1176,-4203,0,-3396,-12138,0,124,1
299011,-1043290,749478,5199,-1585080,1136389,-629,130,0
354913,-159906,-193058,1949,-732526,-898429,-420,130,0
-330,-1025,1355,0,-11848,15661,0,124,1
0,0,0,0,0,0,0,124,1
794979,-1026389,234008,2598,-1558687,355265,208,130,0
704626,-296412,-406916,1298,-683719,-942628,-211,130,0
167056,-1013388,848931,2599,-1522657,1274431,-211,130,0
-438767,985436,-548621,-1952,1630535,-904923,627,130,0
1003637,-867783,-135856,-2,-1301454,-204236,-210,130,0
2955,2699,-5654,0,7793,-16328,-1,124,1
505,121,-626,0,229,-1186,0,124,1
69840,-25340,-44499,1,-40544,-71199,1,124,1
-845032,995187,-147556,2599,1515325,-227697,1675,130,0
-111155,967886,-856083,648,1492911,-1320935,1046,130,0
70492,-40050,-30441,1,-64081,-48706,1,124,1
-1076441,654574,425115,3248,984102,637634,1255,130,0
-420566,-656525,1080340,3249,-987874,1620690,208,130,0
-1025739,278210,750128,2599,426486,1152728,1256,130,0
989337,-502469,-488169,-1301,-829722,-803328,-211,130,0
-352314,204107,148855,648,947444,679110,1045,130,0
22,-132,109,-1,-15249,12694,0,124,1
0,-4898,4898,0,-14145,14145,0,124,1
839831,161206,-998438,2599,244035,-1520144,1045,130,0
-587623,-394565,984786,2598,-653555,1623203,208,130,0
192407,160556,-351014,1949,750750,-1631374,418,130,0
94253,45501,-137806,1948,538763,-1604561,208,130,0
-1000388,194357,809280,3249,296822,1242801,836,130,0
-141,70,70,-1,8167,8167,0,124,1
0,0,0,0,0,0,0,124,1
735827,-1060190,326962,2599,-1594716,490375,-211,130,0
-44852,-588273,635073,1948,-1359688,1464004,-211,130,0
130,-18,-112,0,-2132,-12958,0,124,1
-109146,-130940,240086,0,-169451,310700,1,124,1
-42252,137805,-93604,1949,1598276,-1092610,1046,130,0
-233773,165491,68281,-1,214165,88364,-1,124,1
23400,-133255,111154,1299,-1524543,1270661,-421,130,0
7000,2562,-9562,0,7320,-27320,0,124,1
143655,-72153,-68903,2599,-822600,-810660,-211,130,0
109854,880132,-988688,1298,1324495,-1489980,1255,130,0
11050,-617524,609072,2598,-1425881,1403257,-420,130,0
-330,-1025,1355,0,-11848,15661,0,124,1
-7801,614923,-606473,649,1425252,-1403677,1046,130,0
-934736,13000,926934,5198,18433,1405771,1256,130,0
9414,-7356,-2058,0,-21019,-5880,0,124,1
1950,120904,-120255,2599,1413940,-1415198,836,130,0
5547,58274,-63822,-1,93239,-102115,0,124,1
7800,301611,-306812,2599,1400324,-1428395,1045,130,0
371163,-1067991,700726,3898,-1608332,1054066,-211,130,0
-32101,-38511,70613,1,-61618,112982,1,124,1
239675,-136173,-103501,1,-176224,-133943,0,124,1
977636,-363364,-616874,-2602,-599721,-1015943,-421,130,0
432266,97503,-531070,-1301,285301,-1535226,207,130,0
-258710,-783930,1045239,2599,-1179332,1568531,208,130,0
608422,472567,-1080341,648,711997,-1628860,836,130,0
-53768,66654,-12885,1,106647,-20617,0,124,1
194500,25130,-219631,-1,32521,-284228,0,124,1
-90354,137805,-46802,649,1607912,-551752,1046,130,0
-1032889,261959,776129,5199,395274,1175351,1255,130,0
266509,-338013,71502,-2,-1550308,327824,-630,130,0
1306,-184,-1121,1,-2132,-12958,0,124,1
-222115,190735,31380,0,246833,40610,0,124,1
690325,-482969,-208008,-652,-1111672,-480950,-630,130,0
1075,257,-1333,-1,2976,-15397,-1,124,1
999,366,-1366,-1,4227,-15777,-1,124,1
918,-1390,472,0,-16060,5452,0,124,1
-8008,-1034,9043,1,-2956,25838,0,124,1
133905,864532,-997788,649,1303129,-1504433,1046,130,0
-648725,-321763,972436,1948,-532690,1603303,-421,130,0
-92003,-146356,238359,0,-189402,308465,0,124,1
917834,-921735,5200,1299,-1417921,5865,-839,130,0
622723,-1082941,465417,5199,-1628441,697334,-630,130,0
22750,-317212,296411,1949,-1461910,1362410,-210,130,0
937985,5200,-942536,649,4817,-1416664,208,130,0
-978287,80603,900933,3249,119608,1350889,417,130,0
174,378,-553,-1,10929,-15977,-1,124,1
5040,-296,-4744,0,-854,-13698,1,124,1
45501,-139756,96853,2598,-1598068,1093237,-840,130,0
227508,-349714,125454,3248,-1611474,571650,-631,130,0
119604,-663675,546020,1949,-1531036,1258302,-420,130,0
512869,-991288,478417,-2,-1633469,790130,-421,130,0
-5379,1176,4203,0,3396,12138,0,124,1
541,-1402,860,-1,-16194,9943,-1,124,1
1004287,-867133,-135856,1298,-1301454,-205074,-839,130,0
42251,-509620,468667,1298,-1470708,1351517,-420,130,0
-282111,324362,-40952,1299,1503594,-197324,1255,130,0
881433,111804,-991938,1299,165902,-1489770,627,130,0
125617,-240333,114716,0,-311020,148456,-1,124,1
-855433,-146256,1006887,5198,-223089,1513021,627,130,0
-92003,238359,-146356,0,308465,-189402,0,124,1
-453067,1067339,-613623,649,1627602,-935506,836,130,0
-642875,1050439,-406266,1298,1620480,-628000,1464,130,0
-1066690,640924,430316,4550,973210,650203,1256,130,0
741677,317211,-1055640,3248,473617,-1590108,207,130,0
93603,46151,-137806,1948,542115,-1604980,418,130,0
-347,664,-317,0,1258,-600,1,124,1
-166407,-186557,355563,2599,-862609,1632211,-420,130,0
988687,-501819,-488819,-1951,-829303,-803957,-421,130,0
2955,-5654,2699,0,-16328,7793,-1,124,1
-722178,-339313,1066689,5198,-513418,1599533,-1,130,0
-1076441,655874,423815,3248,985987,635540,1465,130,0
-989988,435516,554470,-2,717025,912672,627,130,0
1087490,-546671,-540821,-2,-821343,-811917,-211,130,0
-469,642,-172,1,1215,-325,1,124,1
511569,-991288,481018,1299,-1633469,793692,-211,130,0
-335413,-226209,562921,1299,-653765,1623203,207,130,0
-979587,85153,898983,4549,125474,1347747,837,130,0
-100754,-555121,658474,2599,-1281973,1517629,-211,130,0
-311362,297711,14950,1299,1383986,60537,1256,130,0
74752,-143656,69552,648,-1633469,783218,-840,130,0
-881434,-109205,993237,2598,-165065,1489979,627,130,0
-986087,105953,885333,5199,156057,1330361,837,130,0
0,0,0,0,0,0,0,124,1
-482,-14,497,1,-427,14354,0,124,1
256,-564,308,0,-16311,8896,0,124,1
221658,786529,-1008188,-1,1212846,-1553659,1046,130,0
-1074491,688375,388064,1948,1033538,579191,1046,130,0
-73,-67,141,1,-7793,16328,1,124,1
76702,-338013,263259,1948,-1556802,1206772,-421,130,0
-347,-317,664,0,-600,1258,1,124,1
315261,-1058240,745577,2598,-1590108,1119631,-421,130,0
0,0,0,0,0,0,0,124,1
-544721,1083590,-538871,-2,1633886,-811707,1255,130,0
55902,-141706,88403,2599,-1618805,998975,-210,130,0
139,-50,-88,1,-5853,-10279,1,124,1
1041339,-354264,-687726,-651,-546724,-1059513,-420,130,0
27059,-70105,43045,-1,-112169,68873,-1,124,1
330862,-54603,-274961,1298,-244874,-1275899,208,130,0
-614,86,527,-1,164,998,0,124,1
-469,642,-172,1,1215,-325,1,124,1
758578,169656,-929535,-1301,280274,-1533131,627,130,0
-392615,1071240,-677976,649,1615034,-1021599,1255,130,0
1144,-1291,147,0,-14922,1707,-1,124,1
30000,30000,30000,90000,60000,60000,180000,124,1
-130005,-865183,999737,4549,-1305015,1503594,417,130,0
-222115,190735,31380,0,246833,40610,0,124,1
-90354,137805,-46802,649,1607283,-549238,1255,130,0
-1260,74,1186,0,854,13698,-1,124,1
-73,-67,141,1,-7793,16328,1,124,1
30000,30000,30000,90000,60000,60000,180000,124,1
2600,487518,-490769,-651,1411636,-1417502,627,130,0
30000,30000,30000,90000,60000,60000,180000,124,1
0,122,-122,0,14145,-14145,0,124,1
-380915,-685776,1072540,5849,-1036052,1611892,209,130,0
30000,30000,30000,90000,60000,60000,180000,124,1
-1306,184,1121,-1,2132,12958,0,124,1
-759229,-172257,932134,648,-285931,1535853,626,130,0
414715,-1079041,667575,3249,-1618805,1000232,-1,130,0
0,0,0,0,0,0,0,124,1
92953,435516,-528470,-1,1261863,-1528942,1046,130,0
1000,366,-1366,0,4227,-15777,0,124,1
5656,-2828,-2828,0,-8167,-8167,0,124,1
136505,-30552,-104004,1949,-342279,-1212009,-211,130,0
-139756,79302,61752,1298,930896,697125,1046,130,0
24700,927584,-951636,648,1396344,-1432584,836,130,0
-100,-36,136,0,-4227,15777,0,124,1
-118955,123504,-1951,2598,1438448,-47760,1465,130,0
-461518,-53953,515469,-2,-157524,1486837,837,130,0
-48102,326312,-276261,1949,1515115,-1286582,626,130,0
649374,-85804,-564872,-1302,-195020,-1306482,207,130,0
958785,-874933,-81904,1948,-1347119,-127150,-629,130,0
-351664,204757,148855,1948,948701,677853,1255,130,0
3999,-5464,1464,-1,-15777,4227,-1,124,1
109204,-134556,27301,1949,-1541719,302269,-420,130,0
995837,-876883,-117005,1949,-1318631,-176377,-630,130,0
128704,-542121,413415,-2,-1562667,1193784,-212,130,0
0,0,0,0,0,0,0,124,1
-1084241,510269,576571,2599,767717,865331,1465,130,0
-81904,139105,-55903,1298,1624879,-664867,1046,130,0
-189808,-163157,354913,1948,-752007,1631582,-211,130,0
-171607,550570,-379615,-652,1596810,-1097847,836,130,0
-47452,-587623,635723,648,-1356127,1466727,-212,130,0
-99454,135855,-35102,1299,1578376,-423135,1255,130,0
30000,30000,30000,90000,60000,60000,180000,124,1
5226,-738,-4487,1,-2132,-12958,0,124,1
349713,-229459,-118955,1299,-1052601,-555941,-840,130,0
-392615,1071240,-677976,649,1615034,-1021808,1046,130,0
289910,29901,-319162,649,143907,-1480553,418,130,0
355563,-183957,-169657,1949,-843547,-789294,-2,130,0
934735,-8451,-923685,2599,-15083,-1406400,417,130,0
-174,553,-378,1,15977,-10929,1,124,1
-590873,-479068,1075790,5849,-730641,1630535,208,130,0
222115,-31380,-190735,0,-40610,-246833,0,124,1
30000,30000,30000,90000,60000,60000,180000,124,1
45922,-69526,23603,-1,-111242,37765,-1,124,1
8008,1034,-9043,-1,2956,-25838,0,124,1
-642,1412,-770,0,16311,-8896,0,124,1
49999,-68301,18301,-1,-109282,29282,-1,124,1
1000,-1366,366,0,-15777,4227,0,124,1
-127405,347763,-219059,1299,1615453,-1018876,836,130,0
-347,664,-317,0,1258,-600,1,124,1
-5040,296,4744,0,854,13698,-1,124,1
2310,-9491,7180,-1,-27119,20516,-1,124,1
-488819,1083590,-594773,-2,1631373,-894658,1256,130,0
1086840,-547321,-539521,-2,-822809,-810660,-420,130,0
-20151,130654,-108555,1948,1524751,-1270452,1046,130,0
960735,-689026,-272361,-652,-1136809,-447853,-840,130,0
-1041340,783929,260659,3248,1179121,390247,1674,130,0
5639,-2435,-3204,0,-7032,-9251,0,124,1
-132,-410,542,0,-11848,15661,0,124,1
-700077,438116,263909,1948,1012590,603909,836,130,0
709176,-1071241,364663,2598,-1606656,546304,-421,130,0
-1044590,356213,689675,1298,547352,1059303,627,130,0
709826,359463,-1067340,1949,538344,-1604352,417,130,0
-1006238,176806,833981,4549,266658,1262701,1255,130,0
0,0,0,0,0,0,0,124,1
551220,-1086841,538220,2599,-1633678,808774,-211,130,0
-25351,930184,-904184,649,1434468,-1393832,1255,130,0
-918,1390,-472,0,16060,-5452,0,124,1
-590873,-478418,1075140,5849,-729175,1630535,417,130,0
30000,30000,30000,90000,60000,60000,180000,124,1
-114,129,-14,1,14922,-1707,1,124,1
227508,-694227,469317,2598,-1601629,1079622,-421,130,0
-113755,-232709,349713,3249,-1072710,1603094,-211,130,0
-1306,184,1121,-1,2132,12958,0,124,1
1084240,-563572,-521320,-652,-848784,-784266,-211,130,0
-54603,-889884,947085,2598,-1370790,1454997,-420,130,0
30000,30000,30000,90000,60000,60000,180000,124,1
506368,-35102,-471918,-652,-97824,-1362830,208,130,0
-41562,-28760,70323,1,-46016,112517,1,124,1
-937336,-4551,946435,4548,-9217,1419177,627,130,0
70710,-35355,-35355,0,-56568,-56568,1,124,1
0,0,0,0,0,0,0,124,1
-973087,94903,884033,5849,141603,1338739,836,130,0
-156137,236390,-80252,1,305917,-103856,1,124,1
-107255,131954,-24051,648,1540252,-297661,1255,130,0
-4301,-1030,5332,1,-2976,15397,1,124,1
83853,-979587,898983,3249,-1472593,1348794,418,130,0
-558371,358163,200207,-1,1035842,576468,836,130,0
473867,-1083591,613622,3898,-1629070,921260,-212,130,0
289910,-1049790,763128,3248,-1580681,1147910,-210,130,0
776,8158,-8935,-1,23309,-25528,0,124,1
-912635,789129,123504,-2,1303758,201722,1466,130,0
56124,-230515,174391,0,-298314,225683,0,124,1
1084240,-508970,-573322,1948,-768975,-863656,-420,130,0
30000,30000,30000,90000,60000,60000,180000,124,1
-9777,6229,3547,-1,17799,10136,-1,124,1
-966587,913284,53952,649,1374350,78133,1256,130,0
-59803,-272361,334112,1948,-1253276,1533968,-211,130,0
-113105,-14951,130654,2598,-167160,1490607,417,130,0
224258,-947736,724777,1299,-1562457,1194203,-420,130,0
592,-557,-34,1,-1055,-65,1,124,1
-369864,-186557,557070,649,-539393,1604979,417,130,0
795629,-1027039,234008,2598,-1558687,355265,-2,130,0
-327613,704626,-375715,1298,1632839,-872245,1255,130,0
457,-516,59,0,-14922,1707,-1,124,1
-846332,1010137,-161857,1948,1522238,-245921,1885,130,0
-502469,476467,26650,648,1374978,77085,1255,130,0
170000,62224,-232224,0,80525,-300525,0,124,1
-88,-439,528,1,-12694,15249,0,124,1
-662,376,286,0,712,541,-1,124,1
646,-188,-457,1,-357,-866,0,124,1
1084240,-469318,-613623,1299,-706342,-922518,-420,130,0
330212,-53953,-275611,648,-241313,-1277993,-1,130,0
550,-160,-389,1,-4639,-11243,0,124,1
-73,-67,141,1,-7793,16328,1,124,1
-44852,950335,-905484,-1,1448084,-1378750,1045,130,0
-1001038,198257,806030,3249,302269,1239240,837,130,0
29251,-932785,905483,1949,-1436355,1391946,-630,130,0
-845682,993887,-147556,649,1515115,-226859,1884,130,0
30000,30000,30000,90000,60000,60000,180000,124,1
-918,1390,-472,0,16060,-5452,0,124,1
-956836,922384,37051,2599,1388803,51530,1465,130,0
-1026389,276260,750778,649,424391,1153985,837,130,0
-70492,40050,30441,-1,64081,48706,-1,124,1
-138456,50051,90353,1948,591550,1022855,627,130,0
0,208206,-208206,0,269443,-269443,0,124,1
663674,399764,-1063440,-2,607889,-1616501,627,130,0
16507,-67798,51291,0,-108478,82066,-1,124,1
93603,46151,-137156,2598,542115,-1605190,208,130,0
191107,-998438,809930,2599,-1537949,1246362,-211,130,0
-65328,56098,9229,-1,89757,14767,-1,124,1
0,0,0,0,0,0,0,124,1
-1548,-7693,9241,0,-21981,26405,0,124,1
1075,257,-1333,-1,2976,-15397,-1,124,1
-565,282,282,-1,8167,8167,0,124,1
-733228,-297062,1032238,1948,-459165,1586965,208,130,0
5850,937985,-943836,-1,1410798,-1418340,1465,130,0
451116,244409,-695527,-2,566623,-1609589,417,130,0
40951,-508970,468667,648,-1468614,1353821,-212,130,0
-153406,351013,-196308,1299,1629697,-915815,836,130,0
558370,-360114,-199558,-1302,-1036471,-575212,-420,130,0
537,-420,-117,0,-12138,-3396,0,124,1
-37609,-186838,224447,0,-241791,290462,1,124,1
-5040,296,4744,0,854,13698,-1,124,1
4000,1464,-5464,0,4227,-15777,0,124,1
5500,-3893,-1606,1,-11243,-4639,0,124,1
-373114,1056289,-683176,-1,1611054,-1040870,1046,130,0
33,-135,102,0,-15661,11848,0,124,1
116354,-130655,17550,3249,-1495007,177004,-420,130,0
566,-584,17,-1,-1106,32,-1,124,1
735177,-1049790,318511,3898,-1592621,480949,209,130,0
-427717,1053039,-624674,648,1624670,-963784,1675,130,0
-32502,-288611,324362,3249,-1331199,1485370,-211,130,0
204988,-211281,6293,0,-273423,8144,0,124,1
51351,-953586,907433,5198,-1450180,1376654,-2,130,0
-967237,293160,675375,1298,481368,1111252,627,130,0
-1033539,809280,224908,649,1217455,334946,1046,130,0
-18862,-198133,216996,1,-256407,280818,1,124,1
-248310,1038738,-791080,-652,1563923,-1190643,837,130,0
-11061,-54952,66014,1,-87924,105622,0,124,1
-738428,-314612,1059539,6499,-476970,1591573,627,130,0
-1409,801,608,0,9251,7032,0,124,1
110,-1276,1165,-1,-14742,13461,0,124,1
-520020,-551221,1077090,5849,-840405,1633258,208,130,0
976986,-81904,-895084,-2,-125056,-1347538,208,130,0
-70710,35355,35355,0,56568,56568,-1,124,1
60290,1850,-62141,-1,2961,-99426,0,124,1
445916,622073,-1068641,-652,946816,-1625509,836,130,0
2568,-5649,3080,-1,-16311,8896,0,124,1
7000,2562,-9562,0,7320,-27320,0,124,1
182006,-354264,174856,2598,-1633887,802070,-630,130,0
3788,6026,-9814,0,17218,-28042,-1,124,1
23400,109204,-131305,1299,1267938,-1525800,1046,130,0
1083590,-583072,-499869,649,-880205,-751589,-212,130,0
-1061490,508969,554470,1949,782799,850668,1255,130,0
736477,-1059540,325662,2599,-1594716,489537,-421,130,0
417315,661074,-1077091,1298,992062,-1619643,418,130,0
-102054,-553821,659124,3249,-1279669,1518676,-211,130,0
958785,-924985,-32502,1298,-1389852,-48808,-631,130,0
-411466,1075790,-663675,649,1618804,-998766,836,130,0
605822,-1074491,470617,1948,-1629907,714720,-211,130,0
74752,-143006,69552,1298,-1633259,783427,-630,130,0
-354264,181356,172906,-2,841661,792016,1256,130,0
0,0,0,0,0,0,0,124,1
5587,-3559,-2027,1,-10279,-5853,1,124,1
-332,-230,562,0,-6643,16244,1,124,1
274960,772228,-1045890,1298,1162363,-1574816,836,130,0
30000,30000,30000,90000,60000,60000,180000,124,1
0,-489,489,0,-14145,14145,0,124,1
115704,-130005,16900,2599,-1494798,176585,-211,130,0
875582,-958786,85153,1949,-1475526,130501,-420,130,0
-614924,1080990,-463468,2598,1628650,-699849,1465,130,0
429016,-536271,107904,649,-1544862,311485,-631,130,0
130,-112,-18,0,-12958,-2132,0,124,1
7000,2562,-9562,0,7320,-27320,0,124,1
-169999,-62224,232224,1,-80525,300525,1,124,1
354913,-159906,-193708,1299,-731270,-899476,-630,130,0
-21850,-47314,69165,1,-75703,110664,0,124,1
-11061,66014,-54952,1,105622,-87924,0,124,1
-957486,873632,85153,1299,1346071,129035,1256,130,0
284060,-326963,44201,1298,-1502967,196694,-211,130,0
165106,761828,-928235,-1301,1258302,-1531036,837,130,0
-9101,126104,-115705,1298,1471545,-1350052,836,130,0
-11061,-54952,66014,1,-87924,105622,0,124,1
-334113,265859,69552,1298,1230861,315046,1045,130,0
-1086841,562921,524569,649,846688,786569,1045,130,0
537570,-423166,-115055,-651,-1218922,-332643,-420,130,0
-1051090,764428,289910,3248,1148748,431723,1046,130,0
-576572,640924,-61753,2599,1483485,-148307,1255,130,0
-58503,-887284,948385,2598,-1367229,1457720,-211,130,0
75402,-143006,68902,1298,-1633678,783846,-840,130,0
30000,30000,30000,90000,60000,60000,180000,124,1
366613,-558371,191757,-1,-1608332,553636,-839,130,0
9868,-4261,-5607,0,-12176,-16020,1,124,1
74292,160869,-235162,-1,208184,-304328,-1,124,1
-323713,282760,42251,1298,1311508,188315,1045,130,0
1038738,-248960,-790430,-652,-375585,-1188967,-210,130,0
-403016,-142356,547320,1948,-412452,1574815,-1,130,0
-1015989,836581,182006,2598,1259768,271686,1674,130,0
-904834,-63703,972436,3899,-99291,1461909,1045,130,0
734527,-1049790,318511,3248,-1592831,481577,-2,130,0
-604523,-475168,1083590,3899,-717863,1629697,208,130,0
70492,-30441,-40050,1,-48706,-64081,1,124,1
841781,-874933,33801,649,-1441801,55510,-420,130,0
566821,-286661,-280161,-1,-824066,-809403,-630,130,0
-986737,107904,884033,5200,158570,1328685,627,130,0
172906,-553821,381564,649,-1596182,1099941,-629,130,0
4301,-5332,1030,-1,-15397,2976,-1,124,1
-1043290,357513,689025,3248,548190,1058465,627,130,0
-704627,297061,410165,2599,684975,941789,837,130,0
-1051740,649374,405615,3249,998765,620458,1046,130,0
-521970,1082290,-559671,649,1633677,-844804,1465,130,0
316561,-1058240,744277,2598,-1591155,1117117,-630,130,0
-1034189,767678,271060,4549,1166553,407843,1465,130,0
-62403,139755,-75403,1949,1631373,-892983,1255,130,0
-973087,94253,883383,4549,141394,1338949,1256,130,0
-664975,1060839,-393265,2599,1616500,-601816,1255,130,0
690325,-1073191,386764,3898,-1612940,580239,-630,130,0
-884,5281,-4396,1,15249,-12694,0,124,1
-141056,70202,72152,1298,823018,810868,1046,130,0
-965937,291860,675375,1298,479273,1112718,417,130,0
65002,-143006,78652,648,-1631374,895076,-840,130,0
-981537,364013,617523,-1,598463,1017199,627,130,0
-784580,-239859,1030288,5849,-366997,1562037,626,130,0
0,0,0,0,0,0,0,124,1
-56124,230515,-174391,0,298314,-225683,0,124,1
-614,527,86,-1,998,164,0,124,1
-113105,-233359,349063,2599,-1074176,1602675,-420,130,0
222115,-190735,-31380,0,-246833,-40610,0,124,1
524569,-79303,-446567,-1301,-227278,-1287001,-211,130,0
-63703,-77353,143655,2599,-886908,1631163,-2,130,0
0,0,0,0,0,0,0,124,1
-67249,14701,52548,0,23522,84077,0,124,1
298361,266509,-565522,-652,771906,-1632212,626,130,0
354263,-159256,-194358,649,-727290,-903037,-421,130,0
-204988,-6293,211281,0,-8144,273423,0,124,1
-707227,347113,362713,2599,799766,833701,1046,130,0
-9625,6814,2811,0,19469,8033,0,124,1
432916,97503,-531070,-651,283835,-1534388,627,130,0
120,-124,3,-1,-14354,427,0,124,1
215158,-561622,347113,649,-1618386,1002326,-1,130,0
215158,-1018589,807330,3899,-1548423,1226043,-212,130,0
18862,-216996,198133,-1,-280818,256407,-1,124,1
456967,600622,-1056940,649,924821,-1628022,627,130,0
242459,710476,-951636,1299,1172418,-1571255,836,130,0
-919785,139105,780679,-1,229163,1286371,837,130,0
827481,195007,-1023139,-651,291376,-1537111,627,130,0
-143006,-838532,982836,1298,-1292238,1511554,-212,130,0
995187,-878183,-115705,1299,-1319678,-174072,-420,130,0
5639,-3204,-2435,0,-9251,-7032,0,124,1
-227509,1031588,-803431,648,1555334,-1210753,626,130,0
-126,118,7,-1,13698,854,-1,124,1
512219,572021,-1083591,649,860513,-1632421,627,130,0
1056289,-310062,-746228,-1,-466496,-1122355,-211,130,0
22750,-317212,297061,2599,-1461072,1363457,-420,130,0
-449817,-245060,699426,4549,-568300,1610007,-211,130,0
1077090,-412766,-662375,1949,-623182,-996043,-421,130,0
-1084891,620773,466717,2599,930896,697334,1255,130,0
-807981,1030288,-221659,648,1552821,-335995,1255,130,0
1053689,-342563,-709827,1299,-522006,-1079413,-210,130,0
599972,-1083591,487518,3899,-1630955,732525,-212,130,0
-374415,1056939,-682526,-2,1611473,-1039404,1046,130,0
-721528,-339963,1066039,4548,-513837,1599533,208,130,0
-114,-14,129,1,-1707,14922,1,124,1
-1205,-37,1242,0,-427,14354,0,124,1
1078390,-430317,-646125,1948,-650204,-972373,-212,130,0
-988688,434866,555120,1298,716815,913091,627,130,0
430,-533,103,0,-15397,2976,-1,124,1
30000,30000,30000,90000,60000,60000,180000,124,1
1053039,-338663,-713077,1299,-515722,-1084441,-211,130,0
134,-29,-105,0,-3396,-12138,0,124,1
531719,-1076441,548620,3898,-1633887,831816,209,130,0
531719,552520,-1083591,648,830559,-1632840,837,130,0
505718,-33802,-472568,-652,-95730,-1364087,-212,130,0
1059539,-505069,-553821,649,-779448,-853392,-420,130,0
0,0,0,0,0,0,0,124,1
-130,18,112,0,2132,12958,0,124,1
-1548,-7693,9241,0,-21981,26405,0,124,1
-140406,59802,81253,649,703409,925031,627,130,0
-73,141,-67,1,16328,-7793,1,124,1
939935,-741028,-198908,-1,-1222902,-326359,-211,130,0
297711,-966587,670825,1949,-1594297,1105806,-420,130,0
30000,30000,30000,90000,60000,60000,180000,124,1
-650675,85803,568121,3249,195019,1306690,418,130,0
-1053040,341912,715676,4548,518025,1082764,836,130,0
13000,-128055,118954,3899,-1474688,1345652,-630,130,0
-72803,-68253,143655,2599,-777354,1632630,-211,130,0
88403,808630,-897034,-1,1336645,-1481601,627,130,0
-261310,-437467,701376,2599,-1011963,1616291,-211,130,0
-1072541,498568,577221,3248,757243,875595,1674,130,0
-1320,5423,-4103,0,15661,-11848,0,124,1
-525870,-461518,989337,1949,-763738,1632211,-1,130,0
2310,7180,-9491,-1,20516,-27119,-1,124,1
227508,-349714,125454,3248,-1611055,569346,-630,130,0
30000,30000,30000,90000,60000,60000,180000,124,1
-276261,700726,-421866,2599,1622365,-979704,1255,130,0
-1062140,334762,730627,3249,501896,1095332,836,130,0
-81904,-58503,142355,1948,-664448,1624251,-1,130,0
-141313,239099,-97786,0,309422,-126546,1,124,1
30000,30000,30000,90000,60000,60000,180000,124,1
-53302,-87104,141705,1299,-993320,1619433,-420,130,0
911984,-791080,-120905,-1,-1305015,-198162,-211,130,0
1043939,-270411,-772879,649,-409939,-1164040,417,130,0
-443967,-623374,1072540,5199,-949121,1626345,417,130,0
182813,43812,-226626,-1,56698,-293281,-1,124,1
1396,-506,-889,1,-5853,-10279,1,124,1
41562,-70323,28760,-1,-112517,46016,-1,124,1
-1074491,689025,387414,1948,1034166,578354,1046,130,0
-646,188,457,-1,357,866,0,124,1
260009,784579,-1042640,1948,1178912,-1568323,1046,130,0
-1260,1186,74,0,13698,854,-1,124,1
-114,-14,129,1,-1707,14922,1,124,1
722827,338662,-1062140,-651,507971,-1598277,-1,130,0
114,14,-129,-1,1707,-14922,-1,124,1
-228159,1031588,-804081,-652,1554915,-1211172,1045,130,0
1069940,-702027,-366614,1299,-1055743,-552171,-840,130,0
37609,186838,-224447,0,241791,-290462,-1,124,1
-977637,628573,349713,649,1037099,574793,628,130,0
279510,-702677,425765,2598,-1622157,980332,-211,130,0
-256,564,-308,0,16311,-8896,0,124,1
276910,770278,-1046540,648,1160059,-1575654,836,130,0
5040,-296,-4744,0,-854,-13698,1,124,1
-31202,-104004,136505,1299,-1184569,1566227,-421,130,0
826180,198907,-1023789,1298,295147,-1538577,418,130,0
-107,133,-25,1,15397,-2976,1,124,1
1082940,-616874,-465418,648,-928174,-700058,-420,130,0
757928,172256,-930185,-1,282578,-1533969,836,130,0
335412,-269111,-65653,648,-1234423,-309601,-630,130,0
437466,640924,-1078391,-1,964412,-1623414,627,130,0
-261310,-437467,701376,2599,-1011754,1616291,-211,130,0
90353,249609,-339963,-1,1166343,-1573350,836,130,0
0,-4898,4898,0,-14145,14145,0,124,1
-453067,-242460,698776,3249,-562225,1609169,208,130,0
9414,-7356,-2058,0,-21019,-5880,0,124,1
-293161,1038738,-745578,-1,1584660,-1136180,1046,130,0
-937336,921084,18850,2598,1402000,25765,1256,130,0
-109146,240086,-130940,0,310700,-169451,1,124,1
141705,-52652,-87754,1299,-586524,-1026836,-421,130,0
1012737,-823581,-185907,3249,-1250762,-284883,-211,130,0
-1144,1291,-147,0,14922,-1707,1,124,1
-288611,-31852,323062,2599,-143489,1480762,627,130,0
-41602,-96204,139755,1949,-1091772,1597857,-630,130,0
-1027039,277560,750778,1299,425648,1153147,1046,130,0
66302,74752,-139106,1948,883974,-1630955,1045,130,0
30000,30000,30000,90000,60000,60000,180000,124,1
0,0,0,0,0,0,0,124,1
-362064,-344513,708526,1949,-799139,1633049,-1,130,0
-209958,-479718,691625,1949,-1109368,1593039,-421,130,0
26000,-930835,906783,1948,-1433632,1395088,-211,130,0
-239675,103501,136173,-1,133943,176224,0,124,1
0,0,0,0,0,0,0,124,1
-45922,69526,-23603,1,111242,-37765,1,124,1
-223609,347113,-121555,1949,1611473,-572699,836,130,0
275610,-1024439,752078,3249,-1577958,1155870,-629,130,0
-82554,139105,-55903,648,1625089,-665286,1255,130,0
685775,-192408,-492719,648,-442197,-1140370,-211,130,0
958135,-925635,-31202,1298,-1389852,-48598,-211,130,0
45922,23603,-69526,-1,37765,-111242,-1,124,1
-565,282,282,-1,8167,8167,0,124,1
355563,-183957,-170307,1299,-843128,-789922,-211,130,0
399,-546,146,-1,-15777,4227,-1,124,1
880132,-835282,-45502,-652,-1376655,-73735,-840,130,0
-461518,-53953,515469,-2,-156686,1486627,627,130,0
-851532,-13651,866482,1299,-25137,1426927,417,130,0
-1058890,314611,746877,2598,470894,1119422,1046,130,0
-845682,995187,-146906,2599,1514696,-226231,1464,130,0
-301,-362,663,0,-685,1256,0,124,1
131304,-351014,221658,1948,-1616082,1014895,-420,130,0
30000,30000,30000,90000,60000,60000,180000,124,1
-662,376,286,0,712,541,-1,124,1
432916,98153,-531720,-651,286139,-1535645,-211,130,0
30000,30000,30000,90000,60000,60000,180000,124,1
-7801,614923,-606473,649,1424414,-1404515,1255,130,0
179406,373764,-554471,-1301,1083392,-1599953,417,130,0
884,-5281,4396,-1,-15249,12694,0,124,1
157305,-353614,198907,2598,-1629907,912672,-210,130,0
235308,110504,-344513,1299,516559,-1599953,208,130,0
349713,-228809,-119605,1299,-1052182,-556569,-1049,130,0
0,8573,-8573,0,24494,-24494,0,124,1
492718,189157,-684476,-2601,441568,-1582357,208,130,0
705276,-1071891,370513,3898,-1608122,553217,-839,130,0
-1375,401,973,-1,4639,11243,0,124,1
1016638,-772229,-242460,1949,-1189177,-375376,-421,130,0
-1073191,498568,577871,3248,757662,875176,1674,130,0
533669,551220,-1083591,1298,828883,-1632840,837,130,0
1060839,-505069,-554471,1299,-779239,-853811,-630,130,0
-166407,-761179,928884,1298,-1258303,1531245,-1,130,0
-53768,66654,-12885,1,106647,-20617,0,124,1
-11051,-117005,130004,1948,-1342092,1477410,-421,130,0
-1075791,392614,686425,3248,586732,1026625,207,130,0
0,0,0,0,0,0,0,124,1
-558,202,355,-1,5853,10279,-1,124,1
458917,55902,-515470,-651,162760,-1488513,209,130,0
277560,770928,-1046540,1948,1160269,-1575654,1046,130,0
-5656,2828,2828,0,8167,8167,0,124,1
85803,-980887,897683,2599,-1473850,1347118,417,130,0
-596723,1081640,-483619,1298,1630744,-730222,1255,130,0
370513,688375,-1057590,1298,1047363,-1608751,836,130,0
-843082,-169657,1017288,4549,-258071,1525799,627,130,0
563,-243,-320,0,-7032,-9251,0,124,1
-928885,-22751,955535,3899,-37077,1432793,627,130,0
-573322,983486,-411466,-1302,1626764,-680577,1046,130,0
-1067991,639623,430966,2598,971953,651669,1465,130,0
-705927,1036788,-329563,1298,1599533,-510276,1046,130,0
-63003,3700,59302,-1,5921,94884,0,124,1
215158,-1018589,807980,4549,-1548004,1226462,208,130,0
525219,-78653,-446567,-1,-226859,-1287210,-1,130,0
343212,-249610,-92954,648,-1147701,-432771,-420,130,0
290560,29251,-319162,649,140975,-1479297,208,130,0
68756,-20082,-48674,0,-32132,-77878,1,124,1
30000,30000,30000,90000,60000,60000,180000,124,1
255459,85153,-338663,1949,398207,-1570627,-2,130,0
0,4898,-4898,0,14145,-14145,0,124,1
-853482,-149506,1008187,5199,-227488,1514696,836,130,0
9145,-1292,-7853,0,-3691,-22439,1,124,1
-99454,-36402,138455,2599,-418736,1576281,208,130,0
-6999,9562,-2562,1,27320,-7320,1,124,1
-90354,137155,-46152,649,1607702,-550914,1045,130,0
904833,66952,-968537,3248,98033,-1460654,417,130,0
-738428,-315912,1059539,5199,-478646,1591992,417,130,0
-1053690,707226,350363,3899,1074175,529546,1464,130,0
-892484,-70853,967886,4549,-109764,1466518,627,130,0
174,-553,378,-1,-15977,10929,-1,124,1
-514820,-567472,1087490,5198,-856115,1632630,-1,130,0
89053,893133,-980887,1299,1344186,-1475736,1046,130,0
114,14,-129,-1,1707,-14922,-1,124,1
213207,136505,-349064,648,640776,-1621110,417,130,0
0,-1224,1224,0,-14145,14145,0,124,1
136505,-31202,-103354,1949,-346887,-1208448,-1,130,0
45922,-69526,23603,-1,-111242,37765,-1,124,1
-967237,913284,53952,-1,1374559,78133,1255,130,0
-460218,-54603,516119,1298,-159828,1487884,837,130,0
-126,118,7,-1,13698,854,-1,124,1
-99,136,-36,1,15777,-4227,1,124,1
902233,-974387,74102,1948,-1467566,111648,-2,130,0
330212,-54603,-275611,-2,-242779,-1276946,627,130,0
-53302,138455,-84504,649,1620061,-994158,836,130,0
51351,-328913,280810,3248,-1514697,1287000,-420,130,0
-36946,70686,-33740,0,113098,-53984,1,124,1
632,-493,-138,1,-935,-261,1,124,1
141705,-52002,-87754,1949,-586733,-1026836,-420,130,0
77352,-338013,263259,2598,-1556802,1206981,-421,130,0
0,0,0,0,0,0,0,124,1
1548,-9241,7693,0,-26405,21981,0,124,1
-705927,394564,312011,648,912044,717862,1046,130,0
419265,658474,-1077091,648,988711,-1620062,-1,130,0
-139106,-840482,981536,1948,-1294961,1509879,-1,130,0
980886,-874933,-104004,1949,-1328267,-159409,-1,130,0
-107,-25,133,1,-2976,15397,1,124,1
-480368,498568,-17551,649,1441800,-54882,1046,130,0
-725428,-322413,1052389,4548,-493309,1595343,207,130,0
-83854,525219,-442017,-652,1520981,-1276737,1046,130,0
55902,-141056,88403,3249,-1618596,1000651,-211,130,0
9868,-4261,-5607,0,-12176,-16020,1,124,1
974386,-92954,-879483,1949,-142861,-1337065,417,130,0
-328913,560971,-232709,-651,1626136,-673874,1046,130,0
-119605,-3901,126104,2598,-38543,1433421,627,130,0
-989338,826180,164456,1298,1273384,250319,1255,130,0
30000,30000,30000,90000,60000,60000,180000,124,1
1020538,-189808,-828132,2598,-288654,-1247829,-1,130,0
-212558,-138456,352963,1949,-639102,1621109,-211,130,0
84503,-142356,59802,1949,-1625090,667170,-211,130,0
648724,-82554,-566172,-2,-190411,-1309205,208,130,0
5500,-1606,-3893,1,-4639,-11243,0,124,1
-237456,86157,151298,-1,111497,195798,-1,124,1
-1084891,490768,598022,3899,735877,895076,836,130,0
109204,-133906,26650,1948,-1541091,300593,-211,130,0
-698127,245709,453716,1298,565785,1044011,626,130,0
0,0,0,0,0,0,0,124,1
-876233,995187,-115705,3249,1495425,-177424,1255,130,0
-120,124,-3,1,14354,-427,0,124,1
156137,-236390,80252,-1,-305917,103856,-1,124,1
988037,-104654,-881434,1949,-161504,-1326591,208,130,0
1073190,-687726,-384165,1299,-1034377,-577936,-421,130,0
92003,-238359,146356,0,-308465,189402,0,124,1
144955,-1003638,861932,3249,-1510508,1294122,-1,130,0
254809,-565522,311361,648,-1630745,901151,-211,130,0
-72803,-67603,143655,3249,-774421,1632420,-211,130,0
30000,30000,30000,90000,60000,60000,180000,124,1
168356,-1014038,848281,2599,-1523495,1272546,418,130,0
-962037,688375,272360,-1302,1136808,448271,1256,130,0
-531720,-136506,671475,3249,-317352,1546117,207,130,0
-469,642,-172,1,1215,-325,1,124,1
-1006888,177456,832681,3249,268125,1261653,1046,130,0
787829,220358,-1006888,1299,337669,-1552193,836,130,0
-506369,988037,-482319,-651,1633886,-795787,1046,130,0
-776,8935,-8158,1,25528,-23309,0,124,1
83,-140,57,0,-16244,6643,-1,124,1
104653,-346463,243109,1299,-1591365,1115651,-421,130,0
989337,-501819,-488819,-1301,-828674,-804585,-420,130,0
-685126,1070590,-384165,1299,1612939,-579821,1255,130,0
254,-658,404,0,-1247,766,0,124,1
-273011,1023138,-748179,1948,1578167,-1155242,837,130,0
1053039,-339963,-712427,649,-517398,-1082765,208,130,0
256,308,-564,0,8896,-16311,0,124,1
-1058240,751428,306161,-651,1129686,457278,836,130,0
3059,-9683,6624,0,-27666,18925,-1,124,1
75402,-143006,68902,1298,-1633469,780914,-630,130,0
443966,-989338,546020,648,-1630536,901360,-2,130,0
137155,-107255,-27952,1948,-1219132,-332643,-1049,130,0
-559671,206707,353613,649,597206,1018246,836,130,0
455017,-1071891,620123,3249,-1627184,940741,-211,130,0
-60290,-1850,62141,1,-2961,99426,0,124,1
-986737,569421,417965,649,939903,687908,1465,130,0
-119605,-3901,125454,1948,-38125,1433002,417,130,0
88,439,-528,-1,12694,-15249,0,124,1
932134,-29902,-902234,-2,-46922,-1390061,209,130,0
-42902,-94904,139755,1949,-1089468,1598486,-630,130,0
-140406,-211258,352963,1299,-973211,1622575,-2,130,0
69840,-44499,-25340,1,-71199,-40544,1,124,1
-155,-482,637,0,-912,1206,1,124,1
209307,-1025089,819680,3898,-1544652,1233165,208,130,0
-493369,-190458,687075,3248,-441569,1582566,208,130,0
7527,1804,-9331,0,5154,-26661,0,124,1
-961387,689025,271710,-652,1137855,446805,1255,130,0
-124805,117654,9100,1949,1373302,80018,1045,130,0
30000,30000,30000,90000,60000,60000,180000,124,1
-851532,-12351,866482,2599,-24090,1426508,417,130,0
880782,-995838,118304,3248,-1495007,176794,-211,130,0
-470,-172,642,0,-325,1215,0,124,1
132,-542,410,0,-15661,11848,0,124,1
-21850,69165,-47314,1,110664,-75703,0,124,1
690325,-1073191,385464,2598,-1612521,578144,-211,130,0
248309,-345163,98803,1949,-1585080,448899,-421,130,0
136505,406265,-543421,-651,1177445,-1568951,1045,130,0
0,0,0,0,0,0,0,124,1
5818,4026,-9845,-1,11504,-28129,0,124,1
-37609,-186838,224447,0,-241791,290462,1,124,1
136505,405615,-544071,-1951,1177027,-1568951,1046,130,0
61752,269760,-330213,1299,1253903,-1533131,1255,130,0
-253510,-86454,342562,2598,-397789,1570835,417,130,0
5639,-2435,-3204,0,-7032,-9251,0,124,1
-128705,111154,19500,1949,1298521,209472,1255,130,0
0,0,0,0,0,0,0,124,1
174,378,-553,-1,10929,-15977,-1,124,1
-113105,128054,-13001,1948,1494378,-174701,1255,130,0
303561,728027,-1031589,-1,1121307,-1589060,837,130,0
-312662,1055639,-742328,649,1590316,-1119213,417,130,0
898983,-963987,68902,3898,-1463377,102851,208,130,0
796929,-1038739,243109,1299,-1562248,366577,-211,130,0
957485,-877533,-77353,2599,-1350261,-121495,-630,130,0
549270,-1087491,540820,2599,-1633887,811706,-420,130,0
126754,-120255,-5851,648,-1373722,-79181,-839,130,0
-130,18,112,0,2132,12958,0,124,1
-1034189,768328,271060,5199,1166972,407214,1046,130,0
9100,-616874,610372,2598,-1423996,1405561,-421,130,0
677325,397164,-1071241,3248,595530,-1614406,627,130,0
-130,18,112,0,2132,12958,0,124,1
0,-575,575,0,-1090,1090,0,124,1
256,-564,308,0,-16311,8896,0,124,1
796279,-1038739,245059,2599,-1562667,368043,-211,130,0
711126,-1039389,330862,2599,-1598906,507971,-630,130,0
-567472,-80604,650674,2598,-187688,1498986,627,130,0
-60290,62141,-1850,1,99426,-2961,0,124,1
-82554,525219,-442667,-2,1520143,-1277993,1046,130,0
1077740,-430967,-645475,1298,-651251,-971535,-211,130,0
-1019239,191107,833331,5199,284673,1250970,836,130,0
30000,30000,30000,90000,60000,60000,180000,124,1
-575922,641574,-63703,1949,1485370,-152916,1464,130,0
-11,127,-116,0,14742,-13461,0,124,1
0,0,0,0,0,0,0,124,1
74292,-235162,160869,-1,-304328,208184,-1,124,1
-795630,907433,-112455,-652,1499196,-186641,1046,130,0
11,-127,116,0,-14742,13461,0,124,1
-1053040,344512,713726,5198,521586,1079831,626,130,0
1062789,-718927,-341913,1949,-1084231,-516351,-421,130,0
496618,589572,-1084891,1299,884393,-1631164,627,130,0
-577222,641574,-61103,3249,1483276,-148098,1046,130,0
440066,640273,-1078391,1948,962526,-1623833,417,130,0
1000,366,-1366,0,4227,-15777,0,124,1
1002987,-141706,-861283,-2,-214291,-1294751,418,130,0
738,674,-1413,-1,7793,-16328,-1,124,1
-253510,-87104,341912,1298,-397161,1570626,417,130,0
30000,30000,30000,90000,60000,60000,180000,124,1
284060,-326963,44201,1298,-1503177,196904,-630,130,0
594122,479067,-1071891,1298,728127,-1629698,837,130,0
-83204,979586,-896384,-2,1473640,-1347329,1046,130,0
-437467,-640274,1080990,3249,-964832,1623622,-2,130,0
1058239,-313312,-744928,-1,-471733,-1118585,-421,130,0
-637024,1079690,-443317,-651,1625298,-667380,1046,130,0
-189158,997137,-806681,1298,1538157,-1245525,1046,130,0
-5818,-4026,9845,1,-11504,28129,0,124,1
537,-117,-420,0,-3396,-12138,0,124,1
843731,135855,-976987,2599,207377,-1506319,207,130,0
0,0,0,0,0,0,0,124,1
205,-650,444,-1,-1231,842,-1,124,1
69840,-25340,-44499,1,-40544,-71199,1,124,1
9777,-6229,-3547,1,-17799,-10136,1,124,1
5200,486218,-492719,-1301,1409332,-1420225,837,130,0
30000,30000,30000,90000,60000,60000,180000,124,1
481668,-501169,19500,-1,-1442639,57395,-630,130,0
365313,-557721,192407,-1,-1608751,556987,-631,130,0
-103,-516,620,1,-978,1175,1,124,1
-21850,-47314,69165,1,-75703,110664,0,124,1
850881,-998438,149505,1948,-1514697,226649,-210,130,0
119604,-663675,545370,1299,-1531874,1257255,-210,130,0
-113105,-14301,131304,3898,-170302,1491864,417,130,0
-60453,-271711,334112,1948,-1252019,1534806,-211,130,0
83853,-979587,898983,3249,-1472803,1348585,208,130,0
0,0,0,0,0,0,0,124,1
0,0,0,0,0,0,0,124,1
141705,-90354,-48752,2599,-1033748,-578564,-420,130,0
-831,-575,1406,0,-6643,16244,1,124,1
-700077,438116,263909,1948,1013428,603071,836,130,0
234008,-1036139,804080,1949,-1556592,1207400,-630,130,0
-523270,1082290,-558371,649,1633677,-842500,836,130,0
757928,172256,-929535,649,283207,-1534178,628,130,0
140405,838531,-979587,-651,1293493,-1510299,836,130,0
414715,-1079041,665624,1298,-1618805,998765,-1,130,0
696826,-245060,-451117,649,-565367,-1044431,-420,130,0
337362,-1064740,729977,2599,-1597858,1093866,-420,130,0
549920,-392615,-157306,-1,-1131781,-453928,-1,130,0
-6429,-3304,9733,0,-9441,27810,0,124,1
-601273,-453717,1058889,3899,-701943,1628021,-1,130,0
131954,-113755,-16901,1298,-1296427,-212615,-420,130,0
-5639,3204,2435,0,9251,7032,0,124,1
25350,-930835,906783,1298,-1433841,1394878,-211,130,0
9868,-5607,-4261,0,-16020,-12176,1,124,1
66302,75402,-139106,2598,887116,-1630745,836,130,0
-709827,-356864,1071240,4549,-538764,1604770,418,130,0
642,770,-1412,0,8896,-16311,0,124,1
-254,658,-404,0,1247,-766,0,124,1
-1017939,189157,833981,5199,281740,1252856,1046,130,0
30000,30000,30000,90000,60000,60000,180000,124,1
-31852,-103354,137155,1949,-1182893,1566855,-630,130,0
-170000,-62224,232224,0,-80525,300525,0,124,1
-5226,4487,738,-1,12958,2132,0,124,1
-26651,930184,-903534,-1,1434678,-1393832,1046,130,0
-656,418,238,0,792,451,0,124,1
156137,-236390,80252,-1,-305917,103856,-1,124,1
1081640,-585022,-497919,-1301,-882509,-749075,-211,130,0
-155,637,-482,0,1206,-912,1,124,1
803430,94903,-900934,-2601,156057,-1485581,627,130,0
299661,-1043290,748178,4549,-1585290,1135551,-630,130,0
0,0,0,0,0,0,0,124,1
-563572,1084240,-521320,-652,1633468,-784895,1046,130,0
-577222,641574,-62403,1949,1483904,-149564,1255,130,0
-92003,238359,-146356,0,308465,-189402,0,124,1
141313,-239099,97786,0,-309422,126546,-1,124,1
-479718,497918,-18201,-1,1442219,-55511,1255,130,0
963336,-290561,-674726,-1951,-480321,-1111672,-211,130,0
511569,573971,-1084241,1299,862189,-1632002,627,130,0
-347114,225558,123504,1948,1048201,561386,1046,130,0
1344,-294,-1050,0,-3396,-12138,0,124,1
-8440,-259,8699,0,-740,24856,0,124,1
141055,-90354,-49402,1299,-1029349,-584010,-420,130,0
-141056,-211258,352963,649,-972582,1622784,-421,130,0
431,221,-653,-1,420,-1237,0,124,1
-977637,631173,345812,-652,1042755,568299,1046,130,0
9899,-4949,-4949,1,-14142,-14142,0,124,1
217758,811230,-1027689,1299,1221854,-1549679,1047,130,0
192407,-999738,808630,1299,-1539415,1244058,-210,130,0
-558,355,202,-1,10279,5853,-1,124,1
353613,-207358,-145606,649,-949121,-676807,-211,130,0
-417966,-658475,1080340,3899,-991225,1620061,-2,130,0
0,0,0,0,0,0,0,124,1
-939936,919134,22100,1298,1399277,31211,1465,130,0
-521320,449816,72152,648,1301244,205702,1465,130,0
139105,-98804,-38352,1949,-1127592,-460212,-839,130,0
-541,-860,1402,1,-9943,16194,1,124,1
-633774,586321,46801,-652,1360734,103270,1465,130,0
122204,-125455,5850,2599,-1436355,44198,-2,130,0
30000,30000,30000,90000,60000,60000,180000,124,1
-9777,3547,6229,-1,10136,17799,-1,124,1
-174,553,-378,1,15977,-10929,1,124,1
-189158,997137,-807331,648,1538367,-1245735,836,130,0
566171,83853,-648725,1299,193552,-1500872,417,130,0
-4823,4971,-148,0,14354,-427,0,124,1
22,109,-132,-1,12694,-15249,0,124,1
537570,-425116,-113105,-651,-1223321,-325940,-420,130,0
-216,-344,560,0,-9943,16194,1,124,1
636373,-589573,-46152,648,-1356965,-109136,-212,130,0
351663,-133906,-216459,1298,-611451,-1006098,-630,130,0
33801,101403,-134556,648,1180169,-1567694,1046,130,0
-938636,742327,195657,-652,1226881,321331,1256,130,0
195657,826180,-1021839,-2,1244477,-1538368,837,130,0
76702,-338013,263259,1948,-1557639,1205515,-629,130,0
-335413,-226209,562921,1299,-654393,1623203,-2,130,0
70492,-40050,-30441,1,-64081,-48706,1,124,1
-674726,519369,157305,1948,1201535,357988,836,130,0
2600,120904,-120905,2599,1412893,-1416455,1046,130,0
63702,269110,-331513,1299,1249295,-1535854,837,130,0
302261,728027,-1030939,-651,1121307,-1589060,1046,130,0
1010787,-163157,-846982,648,-246131,-1275270,-1,130,0
126,-118,-7,1,-13698,-854,1,124,1
46801,585671,-632474,-2,1359058,-1464215,1045,130,0
-533020,-135856,671475,2599,-316304,1545908,418,130,0
1060839,-508320,-551221,1298,-784685,-848155,-210,130,0
-315262,-390665,707226,1299,-904085,1629906,-212,130,0
-205,-444,650,1,-842,1231,1,124,1
0,0,0,0,0,0,0,124,1
-68756,20082,48674,0,32132,77878,-1,124,1
142355,-81904,-59153,1298,-930478,-697335,-211,130,0
5818,4026,-9845,-1,11504,-28129,0,124,1
-45502,-588923,635073,648,-1359269,1464214,-420,130,0
12350,-128055,118304,2599,-1474479,1346071,-211,130,0
-31852,133905,-101404,649,1564970,-1188967,837,130,0
254,-658,404,0,-1247,766,0,124,1
-705927,394564,313961,2598,911415,718491,1046,130,0
985436,-567472,-419266,-1302,-936972,-690422,-630,130,0
5587,-3559,-2027,1,-10279,-5853,1,124,1
354913,-159256,-193708,1949,-728128,-902199,-421,130,0
-366614,1066039,-698127,1298,1608121,-1053439,1255,130,0
48751,913284,-962037,-2,1376235,-1449970,1465,130,0
940585,-924335,-14951,1299,-1402001,-25347,-211,130,0
30000,30000,30000,90000,60000,60000,180000,124,1
169999,-232224,62224,-1,-300525,80525,-1,124,1
-490119,1083590,-592823,648,1631582,-892773,1046,130,0
-639624,-438767,1082940,4549,-662353,1624041,-2,130,0
709176,360113,-1067340,1949,539392,-1604771,-1,130,0
970486,-913285,-55253,1948,-1371418,-83161,-420,130,0
140,-60,-80,0,-7032,-9251,0,124,1
92003,-238359,146356,0,-308465,189402,0,124,1
373113,-981537,609722,1298,-1617758,1005468,-211,130,0
2568,3080,-5649,-1,8896,-16311,0,124,1
941885,-924335,-14951,2599,-1401792,-25766,-421,130,0
-139,50,88,-1,5853,10279,-1,124,1
6429,3304,-9733,0,9441,-27810,0,124,1
365313,-558371,193057,-1,-1608751,557406,-631,130,0
668875,-140406,-529120,-651,-321960,-1225625,-211,130,0
302261,729327,-1030289,1299,1123402,-1588432,837,130,0
913284,-790430,-122855,-1,-1303549,-200466,-2,130,0
494668,189157,-683826,-1,440521,-1581938,418,130,0
-3901,-303562,310061,2598,-1402420,1426718,-420,130,0
-57206,64597,-7391,0,103355,-11826,0,124,1
30000,30000,30000,90000,60000,60000,180000,124,1
-373114,1056939,-683176,649,1611054,-1040451,1256,130,0
458267,529769,-989338,-1302,876224,-1631583,627,130,0
-606473,615573,-7801,1299,1426299,-22833,1255,130,0
558,-355,-202,1,-10279,-5853,1,124,1
649374,321112,-971137,-651,527661,-1602048,417,130,0
-211908,559020,-346463,649,1618595,-1002327,837,130,0
-919785,139105,780679,-1,228744,1286371,627,130,0
139105,-99454,-39002,649,-1128011,-459584,-630,130,0
-999,1366,-366,1,15777,-4227,1,124,1
1075790,-653925,-421216,649,-985988,-634912,-420,130,0
136505,-31202,-104004,1299,-343745,-1210753,-211,130,0
-62403,141055,-76053,2599,1631373,-895287,1255,130,0
-297712,-267811,565521,-2,-773164,1632630,209,130,0
-9899,4949,4949,-1,14142,14142,0,124,1
76702,-338013,262609,1298,-1557220,1206143,-839,130,0
986086,-567472,-419266,-652,-936762,-690632,-630,130,0
346462,-108555,-236609,1298,-495194,-1100570,-630,130,0
87103,-527820,442016,1299,-1522448,1274222,-211,130,0
657824,-556421,-100104,1299,-1283649,-233563,-840,130,0
49401,462167,-511570,-2,1339577,-1479297,626,130,0
365313,690975,-1056290,-2,1052181,-1607703,837,130,0
741027,317861,-1056290,2598,475502,-1590527,626,130,0
85803,810580,-896384,-1,1339158,-1479716,626,130,0
545370,-665625,121554,1299,-1533341,277760,-631,130,0
974386,-93604,-878833,1949,-144118,-1336227,836,130,0
-1068641,703976,366613,1948,1058465,548818,1255,130,0
-5226,738,4487,-1,2132,12958,0,124,1
736477,-1049790,317211,3898,-1592412,479692,-2,130,0
-1052390,341262,716326,5198,516769,1083811,837,130,0
539520,-121555,-418616,-651,-347725,-1208029,-1,130,0
-416666,-659775,1080340,3899,-993320,1619642,-2,130,0
0,0,0,0,0,0,0,124,1
0,0,0,0,0,0,0,124,1
-550,389,160,-1,11243,4639,0,124,1
-295112,1039388,-745578,-1302,1585079,-1135342,1255,130,0
0,0,0,0,0,0,0,124,1
77352,-338013,263259,2598,-1557011,1206143,-421,130,0
768978,-1019239,250909,648,-1567904,386058,-630,130,0
904183,68252,-969837,2598,100337,-1461701,417,130,0
706576,-345813,-360114,649,-797044,-836006,-211,130,0
356213,-1043290,689675,2598,-1606237,1060769,-421,130,0
125617,-240333,114716,0,-311020,148456,-1,124,1
-4576,5167,-591,0,14922,-1707,1,124,1
371813,-1067991,700076,3898,-1608332,1053228,-2,130,0
-11,127,-116,0,14742,-13461,0,124,1
736477,-1049140,315911,3248,-1591993,477388,-211,130,0
551220,-164457,-388065,-1302,-472152,-1118375,-839,130,0
-239675,103501,136173,-1,133943,176224,0,124,1
5850,937985,-943836,-1,1410798,-1418340,1046,130,0
-2164,5608,-3443,1,16194,-9943,1,124,1
295,269,-565,-1,7793,-16328,-1,124,1
-10401,-117005,130004,2598,-1345025,1475106,-2,130,0
-128705,986736,-856733,1298,1503804,-1304806,1255,130,0
-286661,-751429,1042639,4549,-1144559,1581937,417,130,0
-273661,-58503,333462,1298,-268126,1529360,627,130,0
30000,30000,30000,90000,60000,60000,180000,124,1
692275,-1073191,384164,3248,-1612312,576678,-630,130,0
889883,53952,-942536,1299,81275,-1452903,418,130,0
30000,30000,30000,90000,60000,60000,180000,124,1
59802,885983,-945786,-1,1367018,-1457721,836,130,0
-671476,-375065,1048489,1948,-579402,1612101,-2,130,0
-1069291,704626,365963,1298,1059303,547561,1046,130,0
-451117,1067339,-615574,648,1627393,-938229,836,130,0
939935,-741678,-198258,-1,-1223321,-325731,-630,130,0
544070,-665625,122204,649,-1534178,280064,-630,130,0
-311362,298361,14950,1949,1383986,60537,1256,130,0
-86454,-810581,897683,648,-1338112,1480343,-211,130,0
279510,769628,-1047190,1948,1158174,-1576282,1465,130,0
-345163,105953,240509,1299,493936,1101407,836,130,0
-176807,-375715,554470,1948,-1086535,1599533,-420,130,0
143005,-72153,-68903,1949,-823228,-810031,-210,130,0
503768,-477768,-25351,649,-1376027,-74782,-630,130,0
708526,-1071241,365313,2598,-1606656,546723,-211,130,0
-932785,10400,928884,6499,13406,1408075,837,130,0
882083,-995838,116354,2599,-1494169,174490,-211,130,0
-991938,503118,488818,-2,829511,804584,1255,130,0
343862,-248960,-94254,648,-1143302,-439265,-1049,130,0
-44852,950335,-904834,649,1448294,-1378331,1255,130,0
-1060840,510269,553170,2599,784894,848573,1255,130,0
139105,-41602,-95554,1949,-468381,-1120889,-211,130,0
-1205,1242,-37,0,14354,-427,0,124,1
932134,-29902,-902234,-2,-47341,-1389852,-1,130,0
-33152,-287961,323712,2599,-1329943,1486418,-211,130,0
-332,562,-230,0,16244,-6643,1,124,1
378964,-1060840,685775,3899,-1611474,1040450,-421,130,0
690325,-482969,-208008,-652,-1111463,-481159,-840,130,0
-146906,919134,-773529,-1301,1520562,-1277155,1047,130,0
-1409,608,801,0,7032,9251,0,124,1
-1008838,823580,188507,3249,1251808,284044,1464,130,0
1068640,-704627,-362714,1299,-1059094,-547562,-420,130,0
-140406,69552,72152,1298,816943,816734,1046,130,0
-470,-172,642,0,-325,1215,0,124,1
92953,-141056,48751,648,-1607284,551332,-210,130,0
85153,56552,-138456,3249,660257,-1623414,626,130,0
-1038089,711126,329562,2599,1094704,503153,1256,130,0
604522,-1073841,471267,1948,-1629907,715768,-1,130,0
-446567,-619474,1071890,5849,-945351,1626555,208,130,0
848931,-1011438,164456,1949,-1522029,246130,-420,130,0
-92304,-436167,529769,1298,-1261026,1529779,-210,130,0
409515,295111,-702677,1949,682880,-1625718,1255,130,0
-291861,564221,-271711,649,1633677,-786151,1046,130,0
720877,343862,-1063440,1299,514255,-1599324,627,130,0
494018,188507,-683826,-1301,439683,-1581938,209,130,0
-739728,-315912,1059539,3899,-477598,1591782,627,130,0
27059,43045,-70105,-1,68873,-112169,-1,124,1
30000,30000,30000,90000,60000,60000,180000,124,1
-256,564,-308,0,16311,-8896,0,124,1
-366614,1066039,-698777,648,1608331,-1053648,1046,130,0
-81254,139105,-56553,1298,1625508,-669685,1046,130,0
-338013,-724778,1066689,3898,-1091144,1598276,-421,130,0
30000,30000,30000,90000,60000,60000,180000,124,1
-81904,138455,-56553,-2,1625508,-669894,1046,130,0
-738,1413,-674,1,16328,-7793,1,124,1
73,67,-141,-1,7793,-16328,-1,124,1
-367,-188,556,1,-5452,16060,0,124,1
57206,7391,-64597,0,11826,-103355,0,124,1
494668,-1086841,594122,1949,-1631583,891725,-210,130,0
0,0,0,0,0,0,0,124,1
0,0,0,0,0,0,0,124,1
-5587,2027,3559,-1,5853,10279,-1,124,1
73,67,-141,-1,7793,-16328,-1,124,1
88,439,-528,-1,12694,-15249,0,124,1
330212,-54603,-275611,-2,-245502,-1275689,-210,130,0
-768329,1015988,-246360,1299,1567065,-382707,1256,130,0
881433,111804,-990638,2599,165483,-1489770,418,130,0
430,-533,103,0,-15397,2976,-1,124,1
963336,-287311,-676676,-651,-475294,-1115652,-630,130,0
-656,238,418,0,451,792,0,124,1
-939936,-1301,944485,3248,-3980,1416454,628,130,0
1051739,-338663,-713077,-1,-515513,-1084231,208,130,0
30000,30000,30000,90000,60000,60000,180000,124,1
-767029,1016638,-247660,1949,1567693,-384383,1465,130,0
-24701,-926285,954885,3899,-1395298,1433631,-420,130,0
211907,477117,-689026,-2,1106015,-1593669,626,130,0
0,0,0,0,0,0,0,124,1
-1025739,822930,204757,1948,1237774,304782,1046,130,0
-697477,247009,451766,1298,570184,1040450,626,130,0
-539521,122204,418615,1298,352333,1205305,836,130,0
1084240,-619474,-462168,2598,-932363,-695450,-211,130,0
915884,-966587,53952,3249,-1452903,79180,-421,130,0
50051,913284,-962037,1298,1376445,-1449761,1465,130,0
541,-1402,860,-1,-16194,9943,-1,124,1
-62403,139755,-75403,1949,1631582,-891935,1046,130,0
-824881,1023138,-198258,-1,1540881,-299756,1046,130,0
484918,10400,-495969,-651,32677,-1430280,208,130,0
-566172,287960,279510,1298,829511,804584,1464,130,0
457617,-519370,62402,649,-1497102,182031,-421,130,0
23400,-317212,295761,1949,-1463586,1360106,-210,130,0
-1084891,472567,615573,3249,709065,920213,1046,130,0
-228809,1032238,-802131,1298,1555753,-1209286,1046,130,0
0,0,0,0,0,0,0,124,1
-213208,1016638,-803431,-1,1549050,-1223740,1046,130,0
493368,592822,-1084891,1299,888583,-1630955,627,130,0
116354,-130005,16900,3249,-1492703,171558,-420,130,0
564221,-324363,-240510,-652,-932782,-695031,-630,130,0
343862,-248310,-93604,1948,-1143931,-438217,-630,130,0
-54,-86,140,0,-9943,16194,1,124,1
-1057590,434216,624023,649,667170,957918,836,130,0
-170307,550570,-380915,-652,1596181,-1100361,626,130,0
378314,-1061490,686425,3249,-1611055,1041498,-1,130,0
-598673,1069940,-469318,1949,1629906,-716188,1464,130,0
1035488,-809931,-224259,1298,-1216199,-337042,-839,130,0
-261310,-438117,701376,1949,-1012382,1616081,-2,130,0
626623,-29902,-597373,-652,-67032,-1379588,-2,130,0
-626624,30551,599322,3249,67450,1379587,837,130,0
399,146,-546,-1,4227,-15777,-1,124,1
-73,-67,141,1,-7793,16328,1,124,1
347,-664,317,0,-1258,600,-1,124,1
30000,30000,30000,90000,60000,60000,180000,124,1
0,0,0,0,0,0,0,124,1
521319,553170,-1073191,1298,841242,-1632631,1046,130,0
-452417,-244410,699426,2599,-565577,1609588,-1,130,0
-1306,1121,184,-1,12958,2132,0,124,1
-367,556,-188,1,16060,-5452,0,124,1
787829,241159,-1025739,3249,365110,-1560781,836,130,0
-280811,324362,-42252,1299,1504851,-201304,836,130,0
-65328,9229,56098,-1,14767,89757,-1,124,1
2310,-9491,7180,-1,-27119,20516,-1,124,1
537,69,-607,-1,131,-1149,0,124,1
49999,-68301,18301,-1,-109282,29282,-1,124,1
0,0,0,0,0,0,0,124,1
30000,30000,30000,90000,60000,60000,180000,124,1
-269761,1021188,-750779,648,1576700,-1158803,1046,130,0
-550,389,160,-1,11243,4639,0,124,1
-126,7,118,-1,854,13698,-1,124,1
667575,379614,-1046540,649,582753,-1612312,627,130,0
-430,533,-103,0,15397,-2976,1,124,1
565521,-247660,-317212,649,-712627,-916653,-630,130,0
355563,-183957,-169657,1949,-841452,-791598,-211,130,0
-83,-57,140,0,-6643,16244,1,124,1
-598023,-26651,627923,3249,-65356,1445989,417,130,0
647424,323712,-971137,-1,531851,-1603095,208,130,0
-252860,563571,-310062,649,1630954,-897172,627,130,0
-4823,-148,4971,0,-427,14354,0,124,1
0,0,0,0,0,0,0,124,1
532369,136505,-668876,-2,317979,-1545909,627,130,0
-549271,392614,157305,648,1135132,450366,837,130,0
-7801,615573,-606473,1299,1424833,-1404096,837,130,0
-1025739,822280,206057,2598,1237564,305201,1255,130,0
11061,-66014,54952,-1,-105622,87924,0,124,1
60290,-62141,1850,-1,-99426,2961,0,124,1
-664975,1060839,-393265,2599,1616500,-600978,1255,130,0
-5818,9845,-4026,1,28129,-11504,0,124,1
-334763,-227509,562921,649,-657326,1623413,-2,130,0
0,0,0,0,0,0,0,124,1
605822,477117,-1080991,1948,718072,-1629279,627,130,0
23400,-132605,111804,2599,-1524962,1270242,-211,130,0
-1083591,622073,464767,3249,933200,695030,1255,130,0
-302912,-726728,1033538,3898,-1122146,1589059,-421,130,0
36946,33740,-70686,0,53984,-113098,-1,124,1
1320,4103,-5423,0,11848,-15661,0,124,1
647424,324362,-971787,-1,533736,-1603304,209,130,0
-332,562,-230,0,16244,-6643,1,124,1
1075,-1333,257,-1,-15397,2976,-1,124,1
-327613,705276,-375065,2598,1632839,-870778,1256,130,0
-839182,-157306,1002337,5849,-241104,1519933,1045,130,0
4823,-4971,148,0,-14354,427,0,124,1
-155,-482,637,0,-912,1206,1,124,1
36401,910034,-947086,-651,1386499,-1440963,1046,130,0
40301,-508970,469317,648,-1468614,1354031,-421,130,0
768978,-1053040,286660,2598,-1580053,429628,-420,130,0
69840,-25340,-44499,1,-40544,-71199,1,124,1
0,0,0,0,0,0,0,124,1
-797580,-234009,1036788,5199,-355476,1558686,627,130,0
85153,55902,-139106,1949,661514,-1623623,627,130,0
30000,30000,30000,90000,60000,60000,180000,124,1
-573322,984136,-410816,-2,1626555,-680158,627,130,0
549270,-393265,-156006,-1,-1134295,-451414,-839,130,0
156137,-236390,80252,-1,-305917,103856,-1,124,1
73,67,-141,-1,7793,-16328,-1,124,1
-1205,1242,-37,0,14354,-427,0,124,1
-1076441,656524,423815,3898,986616,634911,1674,130,0
-843082,-134556,980886,3248,-209683,1507574,626,130,0
457617,-519370,63052,1299,-1497311,182660,-629,130,0
649374,-82554,-566822,-2,-189573,-1309833,208,130,0
-36402,-910035,952285,5848,-1384405,1443476,-210,130,0
646,-188,-457,1,-357,-866,0,124,1
-3251,-939286,945785,3248,-1411218,1418549,-1,130,0
1064089,-716977,-345163,1949,-1081299,-519702,-211,130,0
434866,642224,-1078391,-1301,966297,-1623414,417,130,0
-598023,1069290,-469318,1949,1629906,-716816,1045,130,0
-376365,704626,-327613,648,1632839,-760596,1255,130,0
-299662,-265860,566171,649,-767299,1632211,-1,130,0
11700,850231,-861933,-2,1405980,-1423367,627,130,0
0,0,0,0,0,0,0,124,1
0,0,0,0,0,0,0,124,1
525219,462167,-988688,-1302,763318,-1631793,836,130,0
-637674,972436,-336713,-1951,1608959,-556150,1256,130,0
-708527,-244410,954235,1298,-405121,1572930,208,130,0
889883,77352,-965287,1948,115628,-1468195,1045,130,0
28601,-931485,906133,3249,-1435307,1393202,-420,130,0
30000,30000,30000,90000,60000,60000,180000,124,1
0,0,0,0,0,0,0,124,1
1057589,-312012,-744928,649,-470267,-1119632,-421,130,0
460217,622073,-1079691,2599,935505,-1626765,1047,130,0
256109,-566172,310061,-2,-1630955,896752,-421,130,0
-686426,193057,495318,1949,445338,1138274,836,130,0
-549921,391314,158605,-2,1131780,454346,627,130,0
50701,-328913,281460,3248,-1514279,1288047,-421,130,0
-189158,-164457,354913,1298,-755987,1631792,-210,130,0
-92954,-436167,529769,648,-1261445,1529360,-1,130,0
-248960,1040038,-789780,1298,1564760,-1188967,836,130,0
110,-1276,1165,-1,-14742,13461,0,124,1
-521320,450466,70202,-652,1303548,201722,1256,130,0
455017,601272,-1056290,-1,925240,-1628022,627,130,0
-847632,1008187,-157956,2599,1520352,-241313,1465,130,0
970486,-913935,-54603,1948,-1371837,-82952,-630,130,0
137,-40,-97,0,-4639,-11243,0,124,1
674725,400415,-1071891,3249,599929,-1615244,627,130,0
1040038,-248960,-789780,1298,-375795,-1188549,-2,130,0
-1409,801,608,0,9251,7032,0,124,1
-45502,-588273,635723,1948,-1359059,1464423,-630,130,0
638323,-1082941,447216,2598,-1625509,670312,-421,130,0
-396515,546020,-148856,649,1581099,-433399,1255,130,0
408865,295761,-702677,1949,685394,-1626137,836,130,0
142355,-81254,-59153,1948,-925660,-702781,-210,130,0
299661,753378,-1051740,1299,1134713,-1584661,1046,130,0
824880,-991938,170306,3248,-1527475,260793,-630,130,0
289910,29901,-319812,-1,144536,-1480763,418,130,0
-430967,-100754,533019,1298,-290539,1537320,627,130,0
738,-1413,674,-1,-16328,7793,-1,124,1
-299662,-749479,1054989,5848,-1133038,1585917,-1,130,0
0,0,0,0,0,0,0,124,1
-566172,286660,280810,1298,826579,807307,1046,130,0
256109,-565522,310711,1298,-1630745,899056,-211,130,0
101403,-137156,38351,2598,-1579425,427533,-212,130,0
484268,9750,-496619,-2601,30792,-1429233,208,130,0
567471,-1088791,524569,3249,-1633678,785732,-839,130,0
115704,14300,-127405,2599,169672,-1491237,417,130,0
30000,30000,30000,90000,60000,60000,180000,124,1
-1260,74,1186,0,854,13698,-1,124,1
-31852,-104004,137155,1299,-1184987,1566227,-420,130,0
-88,528,-439,1,15249,-12694,0,124,1
988687,-500519,-490119,-1951,-826999,-806470,-630,130,0
504,-474,-29,1,-13698,-854,1,124,1
-443,5105,-4661,1,14742,-13461,0,124,1
30000,30000,30000,90000,60000,60000,180000,124,1
-566,584,-17,1,1106,-32,1,124,1
-388065,-593473,983486,1948,-981171,1621318,-421,130,0
514819,570721,-1084241,1299,857581,-1632421,208,130,0
-1034839,766378,273660,5199,1164249,411194,1674,130,0
770278,-1019239,250909,1948,-1567694,385010,-630,130,0
-117655,-863233,986736,5848,-1314861,1497101,-2,130,0
-4823,-148,4971,0,-427,14354,0,124,1
676675,-520670,-154056,1949,-1201745,-357570,-839,130,0
313311,391964,-703977,1298,904922,-1629698,418,130,0
641574,438766,-1079691,649,657534,-1623204,418,130,0
102053,35101,-135206,1948,416431,-1575445,417,130,0
88,-528,439,-1,-15249,12694,0,124,1
-134,105,29,0,12138,3396,0,124,1
232708,-1035489,804730,1949,-1555964,1208866,-2,130,0
-899634,973736,-72153,1949,1467565,-111230,1465,130,0
443,4661,-5105,-1,13461,-14742,0,124,1
-63703,-77353,143655,2599,-888793,1630954,-1,130,0
3788,-9814,6026,0,-28042,17218,-1,124,1
-43,138,-94,1,15977,-10929,1,124,1
127404,-9751,-117005,648,-91540,-1366391,-211,130,0
1074490,-494669,-577872,1949,-752426,-879157,-1,130,0
116354,230108,-345163,1299,1071033,-1603095,627,130,0
-9751,126104,-115055,1298,1474059,-1346491,1046,130,0
848931,-999088,152755,2598,-1515954,230629,-1,130,0
637673,-976987,339312,-2,-1609379,560548,-421,130,0
3999,-5464,1464,-1,-15777,4227,-1,124,1
-929535,-22751,956185,3899,-37077,1432793,627,130,0
64352,-642875,579821,1298,-1482020,1336226,-211,130,0
132,-542,410,0,-15661,11848,0,124,1
343862,-248960,-94254,648,-1143302,-438846,-420,130,0
984786,-887934,-94904,1948,-1338112,-142651,-420,130,0
136505,405615,-543421,-1301,1176608,-1569579,628,130,0
-63003,59302,3700,-1,94884,5921,0,124,1
-134,29,105,0,3396,12138,0,124,1
-5639,3204,2435,0,9251,7032,0,124,1
-47452,-463468,512869,1949,-1340835,1478667,-211,130,0
915884,-135856,-781980,-1952,-225812,-1287839,-2,130,0
-502469,475817,27301,649,1374350,78342,1255,130,0
156655,-353614,200207,3248,-1629698,914976,-421,130,0
-692276,956185,-265210,-1301,1582147,-437379,1256,130,0
958135,-924985,-31202,1948,-1390480,-47970,-630,130,0
-257410,-784580,1044589,2599,-1181008,1568112,207,130,0
-976987,631173,345812,-2,1042336,568299,627,130,0
624673,-28602,-598673,-2602,-62842,-1381473,418,130,0
224258,-947736,724777,1299,-1562457,1194413,-420,130,0
-63053,-77353,142355,1949,-889422,1630954,-421,130,0
614,-86,-527,1,-164,-998,0,124,1
5500,-1606,-3893,1,-4639,-11243,0,124,1
102703,35751,-135206,3248,422506,-1577120,418,130,0
1012087,-824231,-184607,3249,-1252228,-282370,-2,130,0
349713,-228809,-120255,649,-1048202,-560968,-420,130,0
102053,-137806,38351,2598,-1578168,423553,-212,130,0
37701,908734,-947086,-651,1385033,-1442220,1046,130,0
-978287,79952,901583,3248,117933,1351936,627,130,0
4000,1464,-5464,0,4227,-15777,0,124,1
-707227,-245710,955535,2598,-408682,1573768,-2,130,0
-39002,956835,-918485,-652,1443476,-1383987,1255,130,0
532369,551870,-1083591,648,829721,-1632840,1046,130,0
-359464,-707227,1069290,2599,-1064960,1605189,-421,130,0
-192408,997787,-805381,-2,1539624,-1242802,1046,130,0
1074490,-568772,-503769,1949,-865332,-766880,-1,130,0
-576572,642224,-63703,1949,1485161,-152916,836,130,0
-166407,-186557,354913,1949,-862818,1632420,-211,130,0
468017,-694877,229458,2598,-1602885,527242,-630,130,0
-48102,326312,-276911,1299,1514487,-1287210,1046,130,0
-295762,-752079,1053689,5848,-1136809,1584451,-2,130,0
314611,-300312,-11051,3248,-1383987,-60119,-421,130,0
34451,101403,-134556,1298,1182682,-1566856,1046,130,0
-1075141,688375,388064,1298,1033747,578773,837,130,0
-33,135,-102,0,15661,-11848,0,124,1
-278211,-768329,1051089,4549,-1156918,1577119,-211,130,0
-1054340,707876,350363,3899,1075013,528499,1464,130,0
18862,198133,-216996,-1,256407,-280818,-1,124,1
-501819,476467,24700,-652,1378120,71430,1255,130,0
-347,-317,664,0,-600,1258,1,124,1
-43,-94,138,1,-10929,15977,1,124,1
-335413,-227509,562921,-1,-656488,1623622,417,130,0
0,0,0,0,0,0,0,124,1
2955,2699,-5654,0,7793,-16328,-1,124,1
433566,-1056290,625323,2599,-1624671,960851,-211,130,0
-1054340,705926,352963,4549,1071452,532479,1046,130,0
335412,225558,-562922,-1952,654183,-1622995,418,130,0
-705277,393264,314611,2598,909320,721004,1254,130,0
50701,-953586,906783,3898,-1450599,1376445,418,130,0
-109146,-130940,240086,0,-169451,310700,1,124,1
690975,-481019,-209958,-2,-1107483,-486187,-421,130,0
1010787,-824881,-182657,3249,-1254113,-279856,-420,130,0
-988038,435516,553820,1298,717234,912672,1046,130,0
-288611,-31852,322412,1949,-144327,1481181,418,130,0
-106604,-25351,135205,3250,-294938,1538576,417,130,0
-791730,1022488,-229459,1299,1557848,-352124,1465,130,0
767678,282110,-1049790,-2,420202,-1576492,418,130,0
-4301,-1030,5332,1,-2976,15397,1,124,1
2310,7180,-9491,-1,20516,-27119,-1,124,1
-1087491,547320,543420,3249,821761,811916,1046,130,0
-1409,801,608,0,9251,7032,0,124,1
-5172,9896,-4723,1,28274,-13496,0,124,1
-369214,976986,-610373,-2601,1617548,-1007355,627,130,0
5500,-1606,-3893,1,-4639,-11243,0,124,1
214212,-12582,-201630,0,-16283,-260933,0,124,1
-53953,-87104,141705,648,-992482,1619433,-630,130,0
1344,-1050,-294,0,-12138,-3396,0,124,1
339312,-80604,-257410,1298,-368672,-1193576,-1,130,0
365963,-557721,193057,1299,-1608332,556149,-212,130,0
36401,286660,-320463,2598,1328685,-1486838,1046,130,0
-4494,9885,-5391,0,28245,-15404,1,124,1
107,25,-133,-1,2976,-15397,-1,124,1
-261310,-303562,565521,649,-879157,1631792,-1,130,0
-633774,586321,48101,648,1358639,107040,1255,130,0
567471,-287311,-279511,649,-826999,-806470,-420,130,0
41601,-508970,468667,1298,-1469661,1352774,-421,130,0
1043289,-271711,-772879,-1301,-410776,-1163621,-1,130,0
-841782,-154706,1001687,5199,-237961,1518467,418,130,0
-444617,-623374,1071890,3899,-949750,1626136,417,130,0
-298362,963986,-668226,-2602,1595343,-1102246,626,130,0
30000,30000,30000,90000,60000,60000,180000,124,1
350363,-229459,-118305,2599,-1053439,-554894,-840,130,0
657824,-557071,-98804,1949,-1285534,-230211,-420,130,0
-132,-410,542,0,-11848,15661,0,124,1
-911985,965286,-50702,2599,1453112,-79391,1046,130,0
-601273,-454368,1060189,4548,-701734,1628231,208,130,0
-994538,875582,120904,1948,1317164,179099,1256,130,0
-958786,873632,85803,649,1346071,129035,1256,130,0
1306,-184,-1121,1,-2132,-12958,0,124,1
194500,25130,-219631,-1,32521,-284228,0,124,1
-339963,-722178,1066689,4548,-1087373,1599323,-421,130,0
-92003,-146356,238359,0,-189402,308465,0,124,1
400,146,-546,0,4227,-15777,0,124,1
-298362,312661,-12351,1948,1448503,-69126,1465,130,0
-281461,325012,-40952,2599,1503594,-197952,1046,130,0
-700077,438116,263909,1948,1011334,605376,837,130,0
-1084241,622073,464767,2599,932991,695239,1255,130,0
85153,55902,-138456,2599,661724,-1623623,627,130,0
559020,-209308,-351664,-1952,-598883,-1016571,-420,130,0
135205,-989988,859332,4549,-1504433,1303967,208,130,0
0,0,0,0,0,0,0,124,1
7000,2562,-9562,0,7320,-27320,0,124,1
-1344,294,1050,0,3396,12138,0,124,1
-558,355,202,-1,10279,5853,-1,124,1
1057589,-312012,-744928,649,-469638,-1120051,-420,130,0
30000,30000,30000,90000,60000,60000,180000,124,1
273660,772228,-1045890,-2,1162782,-1574816,836,130,0
93603,46151,-137806,1948,544210,-1605399,418,130,0
295,269,-565,-1,7793,-16328,-1,124,1
672775,-1074491,405615,3899,-1617549,609984,-2,130,0
456967,-519370,63052,649,-1497311,183079,-210,130,0
-725428,-322413,1052389,4548,-491842,1595134,627,130,0
-605823,616873,-9101,1949,1427765,-25766,1255,130,0
483618,11050,-496619,-1951,34981,-1431537,-2,130,0
976986,-629874,-347764,-652,-1038776,-572699,-840,130,0
1074490,-408866,-666275,-651,-616898,-1001280,-211,130,0
-550571,165756,386764,1949,476550,1114813,627,130,0
-1059540,581121,480367,1948,894238,737343,1255,130,0
-940586,741027,197607,-1952,1224996,324263,1255,130,0
-8440,-259,8699,0,-740,24856,0,124,1
-523920,1082940,-557721,1299,1633886,-841871,1255,130,0
385464,596072,-982187,-651,983474,-1621110,208,130,0
76052,65652,-138456,3248,773163,-1632212,626,130,0
567471,79952,-648075,-652,186849,-1498149,417,130,0
-1260,1186,74,0,13698,854,-1,124,1
-897684,975036,-74753,2599,1469450,-115839,1464,130,0
-114,-14,129,1,-1707,14922,1,124,1
-800831,-230109,1036138,5198,-349820,1557010,1255,130,0
-729328,1045889,-314612,1949,1592620,-480740,1046,130,0
-169007,550570,-381565,-2,1595134,-1103084,627,130,0
-605823,615573,-8451,1299,1427137,-24509,1255,130,0
-312662,-391965,706576,1949,-908902,1629697,-1,130,0
703976,248959,-954236,-1301,408890,-1573559,418,130,0
854131,154055,-1005588,2598,229372,-1514907,627,130,0
0,208206,-208206,0,269443,-269443,0,124,1
-178757,352313,-172257,1299,1633886,-802071,1046,130,0
-295112,1040038,-745578,-652,1585079,-1134924,1045,130,0
109204,-134556,27301,1949,-1540672,299126,-421,130,0
-539521,122854,417965,1298,353589,1204467,836,130,0
-115055,-232709,349063,1299,-1069359,1603932,-421,130,0
4823,148,-4971,0,427,-14354,0,124,1
-642875,1050439,-406916,648,1620690,-628419,1674,130,0
-747529,934735,-185907,1299,1544232,-309182,1255,130,0
0,0,0,0,0,0,0,124,1
-967237,291210,676025,-2,479273,1112718,626,130,0
789779,220358,-1006888,3249,336413,-1551984,627,130,0
-304862,-3251,309411,1298,-14873,1421900,417,130,0
-69840,44499,25340,-1,71199,40544,-1,124,1
0,4898,-4898,0,14145,-14145,0,124,1
-1040039,248309,794329,2599,372023,1191271,418,130,0
233773,-68281,-165491,1,-88364,-214165,1,124,1
192407,829431,-1020539,1299,1248247,-1536483,1255,130,0
55902,888583,-944486,-1,1369532,-1455626,837,130,0
839831,161856,-999088,2599,243407,-1519934,837,130,0
-1074491,687075,389364,1948,1031234,582124,1256,130,0
1033538,-260010,-771579,1949,-395485,-1174304,418,130,0
-118955,-4551,126104,2598,-42942,1435097,-210,130,0
-577222,640924,-62403,1299,1483695,-148936,1255,130,0
359463,707226,-1066040,649,1063702,-1605190,208,130,0
-323063,283410,41601,1948,1314650,183079,1256,130,0
-701377,436816,264559,-2,1010286,606842,1046,130,0
-809931,1029638,-219059,648,1551354,-331386,1255,130,0
624023,-1082941,463467,4549,-1628022,695030,-211,130,0
-978937,82553,899633,3249,122332,1349423,418,130,0
432266,-1055640,625323,1949,-1624671,961479,-421,130,0
216458,812530,-1027689,1299,1223529,-1548842,1254,130,0
30000,30000,30000,90000,60000,60000,180000,124,1
37609,-224447,186838,0,-290462,241791,-1,124,1
-129355,111154,19500,1299,1298102,210101,1047,130,0
-1375,973,401,-1,11243,4639,0,124,1
-304212,-1951,308761,2598,-11731,1420224,417,130,0
-988038,434866,554470,1298,717025,912881,836,130,0
1026388,-822281,-202158,1949,-1237356,-305202,-421,130,0
-126,7,118,-1,854,13698,-1,124,1
-103354,-553821,659124,1949,-1280088,1518676,-211,130,0
878182,-836582,-41602,-2,-1379378,-68498,-630,130,0
-330863,1060839,-728678,1298,1597019,-1097009,1046,130,0
362713,343862,-705927,648,796415,-1632840,627,130,0
30000,30000,30000,90000,60000,60000,180000,124,1
5500,-1606,-3893,1,-4639,-11243,0,124,1
8440,-8699,259,0,-24856,740,0,124,1
-642,1412,-770,0,16311,-8896,0,124,1
-130005,17550,114404,1949,218898,1292237,417,130,0
30000,30000,30000,90000,60000,60000,180000,124,1
0,0,0,0,0,0,0,124,1
-112455,127404,-13651,1298,1493749,-173234,1256,130,0
525219,-79303,-446567,-651,-227278,-1286791,-1,130,0
115054,230758,-344513,1299,1074385,-1602257,627,130,0
300961,-967887,668225,1299,-1595763,1101407,-839,130,0
-312012,299011,14950,1949,1384614,59071,1256,130,0
7527,1804,-9331,0,5154,-26661,0,124,1
-527820,1072540,-543421,1299,1633677,-827627,1255,130,0
432266,-1056290,625973,1949,-1624461,962526,-421,130,0
458917,529119,-988688,-652,874338,-1631583,627,130,0
-460218,-55903,516119,-2,-163389,1489350,836,130,0
-9414,2058,7356,0,5880,21019,0,124,1
141055,839181,-978937,1299,1294122,-1510089,1046,130,0
-521970,449816,72152,-2,1300825,206330,1255,130,0
530419,137155,-668876,-1302,319864,-1546747,417,130,0
280160,-702677,427065,4548,-1621948,980332,-211,130,0
110,1165,-1276,-1,13461,-14742,0,124,1
593472,479717,-1071891,1298,728336,-1629907,627,130,0
513519,571371,-1084241,649,859256,-1632212,626,130,0
304861,727377,-1030939,1299,1120050,-1589270,1046,130,0
142355,-63053,-78003,1299,-706761,-921890,-211,130,0
-6999,9562,-2562,1,27320,-7320,1,124,1
-9145,7853,1292,0,22439,3691,-1,124,1
-427066,1052389,-624674,649,1624460,-964203,1255,130,0
-1002988,199557,806030,2599,304363,1237983,1255,130,0
-341263,246359,96853,1949,1145815,435912,1046,130,0
949685,-18851,-928235,2599,-31840,-1398021,418,130,0
0,0,0,0,0,0,0,124,1
-177457,-375715,555120,1948,-1085907,1599742,-211,130,0
-337363,78002,260659,1298,367834,1194413,418,130,0
156655,518069,-674076,648,1199440,-1559734,836,130,0
725427,325662,-1049140,1949,494355,-1594716,836,130,0
-297062,963986,-668876,-1952,1594925,-1103922,627,130,0
-8440,8699,-259,0,24856,-740,0,124,1
-90354,-47452,140405,2599,-541906,1605189,-1,130,0
918484,-921085,3900,1299,-1417502,5865,-211,130,0
-365964,-688376,1060839,6499,-1049249,1608959,-2,130,0
11061,-66014,54952,-1,-105622,87924,0,124,1
588272,495318,-1082941,649,744675,-1631164,418,130,0
-298362,-750129,1054339,5848,-1134086,1585289,-211,130,0
-120,124,-3,1,14354,-427,0,124,1
30000,30000,30000,90000,60000,60000,180000,124,1
330212,-54603,-274961,648,-244036,-1276527,-1,130,0
23400,108554,-130655,1299,1268985,-1525171,836,130,0
299011,266509,-565522,-2,771487,-1632212,417,130,0
-312662,-391965,706576,1949,-907855,1629906,208,130,0
0,0,0,0,0,0,0,124,1
0,0,0,0,0,0,0,124,1
785879,243759,-1027689,1949,369090,-1562038,627,130,0
0,0,0,0,0,0,0,124,1
134,-105,-29,0,-12138,-3396,0,124,1
640924,440716,-1079691,1949,660886,-1623414,836,130,0
290560,29251,-319162,649,142231,-1479925,208,130,0
4823,148,-4971,0,427,-14354,0,124,1
920434,-919135,1300,2599,-1415407,837,-839,130,0
367,-556,188,-1,-16060,5452,0,124,1
-254,658,-404,0,1247,-766,0,124,1
-618824,1079690,-460218,648,1628231,-695031,1046,130,0
726077,326312,-1049140,3249,494355,-1594926,626,130,0
-146256,1003637,-856733,648,1512392,-1290562,1045,130,0
-889234,-74103,968536,5199,-113954,1468194,627,130,0
301611,752078,-1051740,1949,1132618,-1585290,836,130,0
551870,-166407,-386765,-1302,-476760,-1114395,-210,130,0
-396515,546670,-149506,649,1581728,-435704,1046,130,0
-139,50,88,-1,5853,10279,-1,124,1
22750,109204,-130655,1299,1269613,-1524752,627,130,0
0,0,0,0,0,0,0,124,1
312661,-1057590,747528,2599,-1589270,1122145,-630,130,0
841131,174856,-1014689,1298,261421,-1526428,836,130,0
-8008,9043,-1034,1,25838,-2956,0,124,1
-1058240,313311,748178,3249,467543,1121726,628,130,0
-140406,60452,80603,649,708436,920632,836,130,0
-820981,991287,-167057,3249,1527893,-261632,1255,130,0
1045239,-273011,-771579,649,-412662,-1162155,-2,130,0
-53768,-12885,66654,1,-20617,106647,0,124,1
401715,143005,-545371,-651,415803,-1575445,208,130,0
107904,881433,-987387,1950,1327428,-1487885,1255,130,0
-317862,23400,295761,1299,112486,1354659,207,130,0
-140406,79302,62402,1298,930687,697334,837,130,0
209957,-1025739,819030,3248,-1545071,1232327,208,130,0
-41562,-28760,70323,1,-46016,112517,1,124,1
671475,377664,-1045240,3899,579191,-1611683,627,130,0
945785,-935386,-9101,1298,-1407866,-14035,-210,130,0
650,-123505,124154,1299,-1411846,1417501,-1,130,0
-1031589,260659,776779,5849,393389,1176608,1046,130,0
995837,-877533,-116355,1949,-1318631,-175958,-421,130,0
-759229,-170307,930834,1298,-282998,1534806,627,130,0
-1072541,495968,579821,3248,753054,879366,1256,130,0
-161857,-763779,926934,1298,-1261654,1529360,-210,130,0
531069,137805,-668876,-2,320912,-1546956,628,130,0
752728,-1057590,306811,1949,-1588222,461468,-420,130,0
669525,-1075141,408215,2599,-1618177,614802,-1,130,0
-103,620,-516,1,1175,-978,1,124,1
537570,-424466,-113105,-1,-1223112,-326568,-630,130,0
-27059,70105,-43045,1,112169,-68873,1,124,1
319161,-25351,-291861,1949,-113325,-1354451,-420,130,0
-74292,-160869,235162,1,-208184,304328,1,124,1
-421866,-655875,1081640,3899,-987664,1620480,-1,130,0
1084890,-487519,-596073,1298,-734621,-896125,-421,130,0
768978,280810,-1049140,648,419154,-1576282,418,130,0
0,0,0,0,0,0,0,124,1
-24701,929534,-903534,1299,1434468,-1393832,1255,130,0
295,269,-565,-1,7793,-16328,-1,124,1
-546021,1083590,-536271,1298,1633886,-809822,1255,130,0
60290,1850,-62141,-1,2961,-99426,0,124,1
-504,474,29,-1,13698,854,-1,124,1
254,-658,404,0,-1247,766,0,124,1
126754,-120255,-5851,648,-1370790,-84209,-631,130,0
-1344,294,1050,0,3396,12138,0,124,1
141705,838531,-979587,649,1293284,-1510508,1046,130,0
50701,-328913,280810,2598,-1515116,1286790,-211,130,0
-120905,-861933,988037,5199,-1312137,1499196,-1,130,0
-986087,106603,885333,5849,157104,1329732,1046,130,0
-7801,-852832,861282,649,-1408704,1420853,-629,130,0
180706,-354264,175506,1948,-1633887,806469,-630,130,0
34451,287310,-319812,1949,1331408,-1484952,837,130,0
-947736,20800,931484,4548,28278,1400324,836,130,0
-5040,296,4744,0,854,13698,-1,124,1
-171607,678625,-505719,1299,1572092,-1171372,1046,130,0
940585,-740378,-199558,649,-1222064,-328035,-840,130,0
-822931,1024438,-200858,649,1542556,-304364,1465,130,0
-452417,1067990,-614274,1299,1627812,-936134,1465,130,0
637023,-976987,340612,648,-1609589,562643,-211,130,0
0,0,0,0,0,0,0,124,1
662374,402365,-1063440,1299,609984,-1616920,418,130,0
-90354,-892484,985436,2598,-1341673,1477829,-2,130,0
-1042640,781979,263259,2598,1175979,394437,1256,130,0
156137,-236390,80252,-1,-305917,103856,-1,124,1
-22101,-928235,953585,3249,-1397393,1431536,-420,130,0
-11061,-54952,66014,1,-87924,105622,0,124,1
0,0,0,0,0,0,0,124,1
-400,546,-146,0,15777,-4227,0,124,1
63702,-642875,579171,-2,-1482439,1335597,-631,130,0
-484269,-11051,496618,1298,-33307,1430907,417,130,0
6999,-9562,2562,-1,-27320,7320,-1,124,1
-926285,956185,-29902,-2,1438029,-47341,1255,130,0
444616,624673,-1067991,1298,950587,-1625090,836,130,0
704626,-295762,-406916,1948,-683091,-943256,-211,130,0
-646,457,188,-1,866,357,0,124,1
-352314,204757,148855,1298,947444,679110,1045,130,0
-211258,-139756,352963,1949,-640987,1621318,-211,130,0
330862,-564222,233358,-2,-1626137,675758,-630,130,0
650024,320462,-970487,-1,527452,-1602048,208,130,0
-1066690,640273,430316,3899,973000,650203,1255,130,0
669525,-137156,-530420,1949,-317352,-1228767,-2,130,0
330,1025,-1355,0,11848,-15661,0,124,1
-140406,59802,81253,649,707598,921470,836,130,0
108554,23400,-131305,649,292633,-1537530,418,130,0
120904,-664325,544720,1299,-1532922,1255369,-212,130,0
-524570,-463468,989987,1949,-767299,1632420,417,130,0
214212,-201630,-12582,0,-260933,-16283,0,124,1
-1748,-3785,5533,0,-10929,15977,1,124,1
-361414,-344513,708526,2599,-797463,1632839,-2,130,0
-537,117,420,0,3396,12138,0,124,1
-546021,1084240,-536921,1298,1633886,-809193,1255,130,0
-844382,-132605,980886,3899,-207797,1506946,627,130,0
-506369,34451,472567,649,98452,1362829,418,130,0
32101,-70613,38511,-1,-112982,61618,-1,124,1
1025088,-277561,-746878,649,-428582,-1150424,-211,130,0
460217,54602,-515470,-651,161503,-1487885,208,130,0
256,308,-564,0,8896,-16311,0,124,1
0,0,0,0,0,0,0,124,1
414065,-1079041,667575,2599,-1618805,1001069,-211,130,0
39001,908734,-947736,-1,1384195,-1443267,1256,130,0
30000,30000,30000,90000,60000,60000,180000,124,1
-543421,1083590,-540171,-2,1633886,-814011,1255,130,0
204988,-211281,6293,0,-273423,8144,0,124,1
121554,-126105,5850,1299,-1437193,45665,-630,130,0
48101,585671,-632474,1298,1358011,-1464843,836,130,0
-202158,-811231,1018588,5199,-1233795,1544651,836,130,0
30000,30000,30000,90000,60000,60000,180000,124,1
-170307,550570,-381565,-1302,1595972,-1100989,836,130,0
-137,40,97,0,4639,11243,0,124,1
0,489,-489,0,14145,-14145,0,124,1
580471,-1060190,482318,2599,-1631793,741323,-840,130,0
273660,56552,-330213,-1,271476,-1530198,418,130,0
0,0,0,0,0,0,0,124,1
41562,-70323,28760,-1,-112517,46016,-1,124,1
-373114,1057589,-682526,1949,1611263,-1040661,1255,130,0
-139106,88403,52651,1948,1031024,582124,1046,130,0
68252,-888584,820980,648,-1467357,1355707,-421,130,0
301,362,-663,0,685,-1256,0,124,1
-46152,-588273,635073,648,-1357384,1465680,-2,130,0
-558,202,355,-1,5853,10279,-1,124,1
-558371,356863,200857,-651,1033747,578982,836,130,0
770278,-1019239,250259,1298,-1567275,383753,-630,130,0
-957486,874282,85803,2599,1346071,129035,1046,130,0
4494,-9885,5391,0,-28245,15404,-1,124,1
-575922,983486,-408216,-652,1626345,-674921,1465,130,0
-328263,560971,-232059,649,1625926,-673246,1255,130,0
30000,30000,30000,90000,60000,60000,180000,124,1
30000,30000,30000,90000,60000,60000,180000,124,1
24050,-317862,296411,2599,-1463377,1360525,-211,130,0
214212,-12582,-201630,0,-16283,-260933,0,124,1
978286,-876883,-101404,-1,-1330780,-155010,209,130,0
-521320,-551221,1077090,4549,-840824,1633258,-2,130,0
0,0,0,0,0,0,0,124,1
194500,25130,-219631,-1,32521,-284228,0,124,1
-85804,525219,-441367,-1952,1523075,-1272966,836,130,0
-8820,8302,518,0,23721,1480,0,124,1
-194500,219631,-25130,1,284228,-32521,0,124,1
558370,-358814,-200858,-1302,-1034377,-577936,-421,130,0
-204988,-6293,211281,0,-8144,273423,0,124,1
9625,-2811,-6814,0,-8033,-19469,0,124,1
30000,30000,30000,90000,60000,60000,180000,124,1
-1054990,705276,353613,3899,1069986,534574,1256,130,0
-662,376,286,0,712,541,-1,124,1
1082940,-581772,-500519,649,-877901,-753474,417,130,0
-1064740,418615,650674,4549,635330,985987,1255,130,0
115704,13650,-127405,1949,167787,-1490608,208,130,0
938635,-742328,-196308,-1,-1224578,-323845,-211,130,0
-937336,922384,18200,3248,1402419,25136,1464,130,0
30000,30000,30000,90000,60000,60000,180000,124,1
738427,318511,-1055640,1298,477178,-1591155,208,130,0
1040038,-249610,-789130,1298,-377470,-1187501,-211,130,0
1007537,-176807,-828132,2598,-269801,-1259979,208,130,0
841131,-875583,35751,1299,-1443058,58233,-421,130,0
-770279,-276911,1053039,5849,-417689,1576491,627,130,0
1260,-74,-1186,0,-854,-13698,1,124,1
-1084891,618823,468017,1949,927754,700895,1255,130,0
-854132,-148206,1007537,5199,-226022,1514068,836,130,0
-642,-770,1412,0,-8896,16311,0,124,1
-563,243,320,0,7032,9251,0,124,1
-519370,-551221,1077090,6499,-840405,1633258,208,130,0
-161857,-763779,926934,1298,-1262073,1528941,-1,130,0
-1071891,499218,577221,4548,758081,874757,1464,130,0
30000,30000,30000,90000,60000,60000,180000,124,1
30000,30000,30000,90000,60000,60000,180000,124,1
-1205,-37,1242,0,-427,14354,0,124,1
30000,30000,30000,90000,60000,60000,180000,124,1
-938636,919134,22100,2598,1399905,30164,1465,130,0
599972,458267,-1056940,1299,703618,-1627813,836,130,0
-42252,136505,-93604,649,1597438,-1095333,836,130,0
1375,-401,-973,1,-4639,-11243,0,124,1
-980237,362063,619473,1299,596368,1019084,836,130,0
-874283,956185,-79953,1949,1474268,-127150,1255,130,0
567471,518069,-1085541,-1,777772,-1632421,837,130,0
-911985,789779,122204,-2,1304386,200255,1046,130,0
1300,939935,-941886,-651,1413731,-1415198,1046,130,0
891183,52651,-941886,1948,79180,-1451856,626,130,0
-764429,1050439,-283411,2599,1579843,-429210,1046,130,0
354913,-183307,-170957,649,-839777,-793274,-421,130,0
800830,233358,-1032239,1949,349400,-1556173,208,130,0
588272,497918,-1083591,2599,746560,-1630955,836,130,0
-627274,27951,600622,1299,63470,1381472,208,130,0
400,146,-546,0,4227,-15777,0,124,1
884033,-57853,-826831,-651,-96777,-1363249,208,130,0
531719,136505,-668876,-652,317560,-1545699,627,130,0
233773,-165491,-68281,1,-214165,-88364,1,124,1
0,0,0,0,0,0,0,124,1
219708,-1020539,804730,3899,-1550517,1221644,208,130,0
426415,-703977,279510,1948,-1622366,642871,-630,130,0
1026388,-824231,-199558,2599,-1239869,-301641,-420,130,0
-1034189,811230,223608,649,1219549,332014,1255,130,0
602572,454367,-1056940,-1,697962,-1627394,1045,130,0
1205,-1242,37,0,-14354,427,0,124,1
-48102,950985,-904184,-1301,1449341,-1377074,836,130,0
-770929,-275611,1052389,5849,-416851,1576072,627,130,0
30000,30000,30000,90000,60000,60000,180000,124,1
-63053,640273,-576572,648,1483066,-1334342,1045,130,0
-130,112,18,0,12958,2132,0,124,1
926284,-958786,35101,2599,-1439916,51530,-420,130,0
-3788,-6026,9814,0,-17218,28042,1,124,1
-5818,9845,-4026,1,28129,-11504,0,124,1
598672,24700,-623374,-2,58861,-1442848,-1,130,0
-274311,1023138,-748179,648,1578586,-1154195,1046,130,0
1063439,-718277,-343213,1949,-1082555,-518236,-211,130,0
566171,-1088791,525219,2599,-1633678,787198,-420,130,0
-204108,1023788,-817731,1949,1543813,-1234842,627,130,0
-36946,70686,-33740,0,113098,-53984,1,124,1
-617524,1079690,-461518,648,1628231,-697335,837,130,0
674725,398464,-1071891,1298,597835,-1614825,418,130,0
-45922,69526,-23603,1,111242,-37765,1,124,1
30000,30000,30000,90000,60000,60000,180000,124,1
8820,-518,-8302,0,-1480,-23721,0,124,1
970486,-913285,-55253,1948,-1371209,-83790,-631,130,0
-4000,-1464,5464,0,-4227,15777,0,124,1
-460868,-55253,515469,-652,-161294,1488303,627,130,0
-88,-439,528,1,-12694,15249,0,124,1
-83204,-57853,141705,648,-660468,1623832,-1,130,0
507018,-1061490,556420,1948,-1633259,855905,-211,130,0
100,36,-136,0,4227,-15777,0,124,1
917184,-137806,-780030,-652,-228535,-1285953,208,130,0
-156137,-80252,236390,1,-103856,305917,1,124,1
-215809,1017288,-801481,-2,1550516,-1220807,1255,130,0
-598023,1080340,-482969,-652,1630744,-728337,1464,130,0
361413,345812,-706577,648,799557,-1632840,627,130,0
-1063440,720226,346462,3248,1082554,518235,836,130,0
0,4898,-4898,0,14145,-14145,0,124,1
-537,420,117,0,12138,3396,0,124,1
-1033539,767678,271710,5849,1166134,408262,1256,130,0
84503,-980237,898983,3249,-1473222,1348375,-211,130,0
16507,-67798,51291,0,-108478,82066,-1,124,1
1396,-506,-889,1,-5853,-10279,1,124,1
-632,493,138,-1,935,261,-1,124,1
-9625,2811,6814,0,8033,19469,0,124,1
-989988,826180,165756,1948,1271918,252833,1465,130,0
-501169,1058889,-556421,1299,1633258,-858420,1255,130,0
91,-139,47,-1,-16060,5452,0,124,1
0,0,0,0,0,0,0,124,1
-295,565,-269,1,16328,-7793,1,124,1
984136,-889234,-93604,1298,-1339159,-140766,-420,130,0
66302,76052,-138456,3898,888792,-1630745,1046,130,0
-1083591,511569,575271,3249,769602,863446,1465,130,0
194357,828131,-1021189,1299,1246362,-1537321,1255,130,0
-656,418,238,0,792,451,0,124,1
690325,-1073191,386764,3898,-1612940,580239,-1049,130,0
-11,127,-116,0,14742,-13461,0,124,1
-139,50,88,-1,5853,10279,-1,124,1
-74753,336062,-258710,2599,1558476,-1203421,627,130,0
-5818,-4026,9845,1,-11504,28129,0,124,1
131304,865182,-997138,-652,1304386,-1503595,1046,130,0
-549271,391314,158605,648,1132618,453089,417,130,0
136505,-30552,-104004,1949,-343117,-1211591,-631,130,0
537,-420,-117,0,-12138,-3396,0,124,1
-3325,-2300,5625,0,-6643,16244,1,124,1
132604,-989338,860632,3898,-1503386,1305643,-1,130,0
-491419,1083590,-590873,1298,1631582,-890678,1046,130,0
9414,-2058,-7356,0,-5880,-21019,0,124,1
-575272,982836,-408866,-1302,1626136,-675131,1046,130,0
-300312,-750129,1054339,3898,-1131781,1585917,-1,130,0
-3788,-6026,9814,0,-17218,28042,1,124,1
1344,-294,-1050,0,-3396,-12138,0,124,1
706576,246359,-953586,-651,405539,-1572721,-1,130,0
565,-282,-282,1,-8167,-8167,0,124,1
137,-97,-40,0,-11243,-4639,0,124,1
3673,1888,-5562,-1,5452,-16060,0,124,1
221,-1320,1099,0,-15249,12694,0,124,1
0,575,-575,0,1090,-1090,0,124,1
-876233,995187,-117005,1949,1495844,-178471,1256,130,0
30000,30000,30000,90000,60000,60000,180000,124,1
5656,-2828,-2828,0,-8167,-8167,0,124,1
131954,-988688,861282,4548,-1502967,1306481,-211,130,0
-991938,503118,488818,-2,828673,805422,1464,130,0
603222,454367,-1056940,649,698172,-1627603,418,130,0
-676026,-394565,1074490,3899,-597836,1615662,836,130,0
-918,-472,1390,0,-5452,16060,0,124,1
-510920,-572022,1086190,3248,-862190,1632420,-2,130,0
-113755,-14951,131304,2598,-168207,1490817,418,130,0
984786,-887284,-95554,1948,-1337274,-144118,-421,130,0
0,208206,-208206,0,269443,-269443,0,124,1
918,472,-1390,0,5452,-16060,0,124,1
-510270,987386,-479068,-1952,1633677,-790550,1046,130,0
460217,54602,-514820,-1,160665,-1487466,417,130,0
-83854,525219,-442017,-652,1521190,-1276737,836,130,0
988037,-502469,-487519,-1951,-829931,-803328,-420,130,0
-550571,163806,388064,1299,473198,1117536,626,130,0
-839832,-157306,1002337,5199,-241104,1519724,417,130,0
0,0,0,0,0,0,0,124,1
-216,560,-344,0,16194,-9943,1,124,1
-592,557,34,-1,1055,65,-1,124,1
-1034189,808630,226208,649,1216407,336832,1255,130,0
-410816,1075140,-663675,649,1619014,-999604,1256,130,0
1064739,-352964,-710477,1298,-534784,-1069149,-211,130,0
-1951,-488819,492718,1948,-1410171,1419386,-421,130,0
-344513,105303,240509,1299,492051,1102873,836,130,0
886633,-61753,-824881,-1,-103271,-1359688,-2,130,0
-694877,955535,-262610,-1952,1581099,-433399,1255,130,0
-1085541,619473,468017,1949,928382,700267,1255,130,0
-139756,59802,81253,1299,703199,925240,836,130,0
30000,30000,30000,90000,60000,60000,180000,124,1
734527,-1060190,327612,1949,-1595135,492260,-2,130,0
60290,-62141,1850,-1,-99426,2961,0,124,1
49401,462817,-511570,648,1339996,-1478878,1045,130,0
75402,65652,-138456,2598,773373,-1632212,627,130,0
55252,-141706,88403,1949,-1618805,998556,-420,130,0
-1051740,648724,406915,3899,997089,622552,1045,130,0
-166407,-187208,355563,1948,-864285,1632420,-211,130,0
-1034189,768978,269760,4549,1168229,405329,1256,130,0
-297062,-751429,1054339,5848,-1135133,1585079,-2,130,0
66302,-643525,577871,648,-1484533,1332665,-210,130,0
1017288,-837882,-177457,1949,-1261654,-267497,209,130,0
149505,-1005588,859332,3249,-1512812,1291189,-420,130,0
0,0,0,0,0,0,0,124,1
-102054,-554471,658474,1949,-1281135,1518048,-1,130,0
958785,-924335,-33152,1298,-1388804,-51112,-630,130,0
900933,-976987,78002,1948,-1469870,117095,-420,130,0
-507019,987386,-481669,-1302,1633886,-795159,1255,130,0
22,-132,109,-1,-15249,12694,0,124,1
905483,66302,-969187,2598,97614,-1460444,418,130,0
-655225,-419266,1079690,5199,-632189,1620271,208,130,0
45501,-139756,96853,2598,-1597439,1095961,-839,130,0
735177,-1060190,327612,2599,-1595344,492679,-1,130,0
-304212,-2601,309411,2598,-14035,1421481,627,130,0
-427717,1052389,-624024,648,1624670,-963575,1256,130,0
-8820,8302,518,0,23721,1480,0,124,1
522619,466067,-989338,-652,769183,-1632212,207,130,0
635723,-590873,-43552,1298,-1360107,-104318,-1049,130,0
400415,143005,-546021,-2601,416222,-1575445,417,130,0
-91654,-47452,140405,1299,-542325,1605189,-210,130,0
45501,-139756,96853,2598,-1597230,1096380,-630,130,0
8008,-9043,1034,-1,-25838,2956,0,124,1
-1375,401,973,-1,4639,11243,0,124,1
-222115,31380,190735,0,40610,246833,0,124,1
566821,-286661,-280161,-1,-825742,-807518,-421,130,0
-212558,1015988,-804081,-651,1548003,-1224997,1046,130,0
209957,479067,-688376,648,1110205,-1592621,837,130,0
-1008838,825530,186556,3248,1254322,280064,1464,130,0
-182813,226626,-43812,1,293281,-56698,1,124,1
216,-560,344,0,-16194,9943,-1,124,1
970486,-61103,-908085,1298,-93216,-1365343,208,130,0
-1059540,314611,747528,2599,469637,1120050,627,130,0
-351664,1041339,-688376,1299,1606027,-1062655,837,130,0
-640925,-438117,1082940,3898,-660258,1624041,418,130,0
0,0,0,0,0,0,0,124,1
432266,-1055640,625973,2599,-1624671,962526,-421,130,0
1039388,-250260,-789130,-2,-377051,-1187920,-211,130,0
-918,-472,1390,0,-5452,16060,0,124,1
-1083591,512219,575271,3899,770650,862608,1465,130,0
566821,80603,-648075,-651,188106,-1498568,418,130,0
-796930,-234009,1036788,5849,-355266,1558686,837,130,0
-1052390,342562,715676,5848,518444,1082764,1255,130,0
586971,497268,-1082941,1298,746560,-1630955,627,130,0
213858,135855,-349714,-1,635749,-1620481,627,130,0
-88,-439,528,1,-12694,15249,0,124,1
64352,-642225,579171,1298,-1481810,1336435,-211,130,0
811880,-1033539,224258,2599,-1552612,335784,-211,130,0
0,0,0,0,0,0,0,124,1
192407,-999088,809280,2599,-1538577,1244896,-210,130,0
-137,97,40,0,11243,4639,0,124,1
377664,668875,-1047190,-651,1028929,-1612731,626,130,0
315911,653924,-969837,-2,1079622,-1601000,1046,130,0
-213859,1016638,-802131,648,1550097,-1221855,1883,130,0
5172,-9896,4723,-1,-28274,13496,0,124,1
841781,-875583,36401,2599,-1443686,59280,-839,130,0
-764429,1049789,-284711,649,1580261,-430048,1255,130,0
-925635,956185,-29902,648,1437820,-46922,1046,130,0
1036138,-767029,-268461,648,-1164040,-410567,-1,130,0
-9625,2811,6814,0,8033,19469,0,124,1
1300,940585,-941236,649,1413940,-1415198,836,130,0
256109,787179,-1041340,1948,1182682,-1567066,836,130,0
346462,-108555,-236609,1298,-492890,-1102246,-421,130,0
1037438,-712427,-323063,1948,-1098266,-498336,-840,130,0
-330,1355,-1025,0,15661,-11848,0,124,1
120,3,-124,-1,427,-14354,0,124,1
-142356,-839182,982836,1298,-1292866,1511345,-2,130,0
-635074,973086,-339963,-1951,1609797,-561178,1046,130,0
139755,-41602,-96204,1949,-468381,-1121098,-420,130,0
-437,1383,-946,0,15977,-10929,1,124,1
-9145,7853,1292,0,22439,3691,-1,124,1
-1004938,863882,141705,649,1298102,210520,1256,130,0
-1548,9241,-7693,0,26405,-21981,0,124,1
1058889,-580472,-477118,1299,-895496,-735250,-211,130,0
139105,-98804,-39002,1299,-1126545,-461678,-839,130,0
-1009488,823580,188507,2599,1252227,283416,1465,130,0
436816,643524,-1078391,1949,966716,-1622995,627,130,0
-224909,691625,-465418,1298,1602256,-1078156,1046,130,0
-78653,978286,-898334,1299,1470707,-1351099,836,130,0
-789780,1023138,-232059,1299,1559105,-356314,1465,130,0
648724,322412,-971137,-1,529337,-1602467,626,130,0
-140406,59802,81253,649,710112,918956,627,130,0
300961,-1044590,747528,3899,-1585918,1133666,-420,130,0
-33,-102,135,0,-11848,15661,0,124,1
989337,-503119,-486869,-651,-831817,-801234,-212,130,0
-92304,-436817,529769,648,-1262702,1528731,-211,130,0
131954,-19501,-110505,1948,-220994,-1290771,-1,130,0
30000,30000,30000,90000,60000,60000,180000,124,1
-705927,392614,314611,1298,907226,723309,1256,130,0
-537571,421215,117004,648,1218712,333061,837,130,0
946435,-934736,-8451,3248,-1407657,-14454,-211,130,0
-118955,661724,-542121,648,1533130,-1254742,836,130,0
1068640,-703327,-365314,-1,-1057628,-549657,-839,130,0
567471,-1087491,524569,4549,-1633469,785732,-2,130,0
22750,-317862,297061,1949,-1462120,1361991,-211,130,0
-101404,-554471,658474,2599,-1281135,1518048,-1,130,0
-42902,-94904,140405,2599,-1088211,1598905,-629,130,0
0,-123505,124804,1299,-1412056,1417501,-2,130,0
-739078,-315262,1059539,5199,-476341,1591573,627,130,0
-33,135,-102,0,15661,-11848,0,124,1
70492,-30441,-40050,1,-48706,-64081,1,124,1
333462,-1062790,732577,3249,-1596601,1098474,-211,130,0
144305,-921085,776779,-1,-1518677,1280716,-210,130,0
400,146,-546,0,4227,-15777,0,124,1
-120,-3,124,1,-427,14354,0,124,1
30000,30000,30000,90000,60000,60000,180000,124,1
240509,711126,-952286,-651,1173884,-1570627,836,130,0
894433,88403,-979587,3249,130710,-1474688,836,130,0
-388715,-594123,982836,-2,-980752,1621528,-211,130,0
880782,112454,-991938,1298,166949,-1490189,627,130,0
339962,-80604,-256760,2598,-369720,-1192738,-2,130,0
-60453,967886,-907434,-1,1458767,-1366181,1046,130,0
-457,516,-59,0,14922,-1707,1,124,1
84503,56552,-138456,2599,662352,-1623833,627,130,0
-489469,1082940,-593473,-2,1631373,-892983,836,130,0
431616,99453,-532370,-1301,290329,-1536902,-2,130,0
-738,1413,-674,1,16328,-7793,1,124,1
-352964,157955,196307,1298,731059,899685,627,130,0
41562,28760,-70323,-1,46016,-112517,-1,124,1
-632,493,138,-1,935,261,-1,124,1
-313962,-655225,970486,1299,-1082765,1600371,-420,130,0
102703,553820,-655875,648,1282601,-1517002,836,130,0
-135856,-407566,544070,648,-1178075,1569159,207,130,0
521969,-451117,-70203,649,-1301873,-204027,-839,130,0
-8008,9043,-1034,1,25838,-2956,0,124,1
-889884,-74103,969186,5199,-115210,1468822,837,130,0
-332,-230,562,0,-6643,16244,1,124,1
205,444,-650,-1,842,-1231,-1,124,1
-133906,104003,31201,1298,1214522,339345,1045,130,0
54602,85153,-138456,1299,993110,-1619224,418,130,0
995187,-876883,-116355,1949,-1318422,-176377,-631,130,0
848281,16250,-865183,-652,25346,-1426509,209,130,0
-1548,-7693,9241,0,-21981,26405,0,124,1
88,439,-528,-1,12694,-15249,0,124,1
566821,-287961,-278861,-1,-828256,-805004,-421,130,0
899633,-963337,65652,1948,-1461072,97823,-1,130,0
-665625,1060189,-393265,1299,1616291,-601187,1256,130,0
9625,-6814,-2811,0,-19469,-8033,0,124,1
-2955,-2699,5654,0,-7793,16328,1,124,1
3059,-9683,6624,0,-27666,18925,-1,124,1
65002,-143006,78652,648,-1631374,892144,-420,130,0
-351664,204107,148205,648,949120,677225,1046,130,0
-494019,-190458,687075,2598,-441988,1582356,-211,130,0
958135,-924985,-31852,1298,-1389852,-48808,-421,130,0
-427066,533019,-105954,-1,1544232,-309811,836,130,0
-1039389,248959,794329,3899,372023,1191271,627,130,0
-91004,137805,-46152,649,1606446,-545677,627,130,0
985436,-566822,-419916,-1302,-935715,-691889,-630,130,0
-32101,70613,-38511,1,112982,-61618,1,124,1
57852,886633,-945136,-651,1368275,-1456883,627,130,0
-895734,960085,-61753,2598,1461281,-97405,1465,130,0
16507,51291,-67798,0,82066,-108478,-1,124,1
0,-1224,1224,0,-14145,14145,0,124,1
282110,-703327,423815,2598,-1622785,975933,-839,130,0
117004,230108,-344513,2599,1070405,-1603304,627,130,0
968536,-113105,-855433,-2,-176167,-1318003,-211,130,0
21850,47314,-69165,-1,75703,-110664,0,124,1
1060839,-330213,-729328,1298,-498336,-1097847,-211,130,0
-662,376,286,0,712,541,-1,124,1
-656525,555770,102053,1298,1285324,231048,1256,130,0
50000,18301,-68301,0,29282,-109282,0,124,1
0,0,0,0,0,0,0,124,1
289260,750778,-1038739,1299,1143720,-1581519,1046,130,0
1306,-1121,-184,1,-12958,-2132,0,124,1
-221,-1099,1320,0,-12694,15249,0,124,1
-224909,690975,-465418,648,1602256,-1077528,1046,130,0
109146,130940,-240086,0,169451,-310700,-1,124,1
991287,-826181,-163807,1299,-1271919,-252206,-840,130,0
-489469,1083590,-593473,648,1631582,-893192,1465,130,0
374414,-1068641,698126,3899,-1609170,1049667,-211,130,0
-661725,-399115,1066689,5849,-609775,1617548,418,130,0
904183,66952,-969187,1948,98452,-1460863,208,130,0
-362714,-343863,708526,1949,-796835,1633049,-1,130,0
-521320,450466,70852,-2,1302710,202979,1256,130,0
-362064,-344513,708526,1949,-798510,1633049,209,130,0
-43,-94,138,1,-10929,15977,1,124,1
-1024439,276260,751428,3249,423134,1154822,836,130,0
4494,5391,-9885,0,15404,-28245,-1,124,1
0,0,0,0,0,0,0,124,1
30000,30000,30000,90000,60000,60000,180000,124,1
-506369,33801,473217,649,96357,1364086,627,130,0
-542771,662374,-117655,1948,1533340,-277133,1465,130,0
-31852,-288611,323712,3249,-1332037,1484742,-420,130,0
5587,-3559,-2027,1,-10279,-5853,1,124,1
5656,-2828,-2828,0,-8167,-8167,0,124,1
-550,389,160,-1,11243,4639,0,124,1
-53953,-889884,946435,2598,-1370580,1455206,-420,130,0
-705927,394564,313961,2598,910996,719119,1255,130,0
-949036,24050,929534,4548,33515,1397811,837,130,0
-872983,956835,-82554,1298,1475944,-130502,1255,130,0
-704627,296411,410165,1949,684137,942836,836,130,0
1050439,-765079,-284711,649,-1150424,-429420,-630,130,0
8008,1034,-9043,-1,2956,-25838,0,124,1
537,-607,69,-1,-1149,131,0,124,1
-533020,-548621,1086190,4549,-829093,1633468,209,130,0
-454368,516769,-60453,1948,1496053,-178681,1255,130,0
-65328,9229,56098,-1,14767,89757,-1,124,1
928884,26000,-952936,1948,36657,-1432375,-2,130,0
-165107,1012087,-846982,-2,1522866,-1273385,836,130,0
1037438,-711777,-325013,648,-1095962,-501059,-630,130,0
-260660,-304212,565521,649,-880414,1631792,-1,130,0
-932785,27951,906783,1949,42104,1392993,628,130,0
0,0,0,0,0,0,0,124,1
960735,-687726,-273661,-652,-1134505,-450995,-840,130,0
-441367,-624024,1072540,7149,-951425,1625926,208,130,0
947085,-14951,-929535,2599,-25975,-1401163,208,130,0
691625,-1072541,385464,4548,-1612521,577725,-420,130,0
-656525,-419266,1079690,3899,-632608,1620271,-1,130,0
332,230,-562,0,6643,-16244,-1,124,1
135855,-30552,-104004,1299,-346259,-1208867,-1,130,0
504,-29,-474,1,-854,-13698,1,124,1
343862,-248960,-93604,1298,-1145397,-436542,-1049,130,0
1068640,-639624,-427717,1299,-972792,-650204,-2,130,0
662,-376,-286,0,-712,-541,1,124,1
191107,-999088,810580,2599,-1538368,1245524,-630,130,0
605822,477767,-1080341,3248,717443,-1629070,836,130,0
-156656,-517420,677325,3249,-1198394,1560362,-211,130,0
522,-73,-448,1,-2132,-12958,0,124,1
4000,1464,-5464,0,4227,-15777,0,124,1
-140406,-839182,982186,2598,-1294123,1510507,-211,130,0
-301,663,-362,0,1256,-685,0,124,1
83,57,-140,0,6643,-16244,-1,124,1
66302,75402,-137806,3898,885022,-1630955,837,130,0
85803,-526520,442666,1949,-1520353,1277573,-421,130,0
4494,-9885,5391,0,-28245,15404,-1,124,1
-980237,365963,616223,1949,601815,1014685,1046,130,0
-9868,5607,4261,0,16020,12176,-1,124,1
-217759,-341913,562271,2599,-988502,1620480,-2,130,0
0,122,-122,0,14145,-14145,0,124,1
431616,-1054990,626623,3249,-1624461,963155,-630,130,0
-36946,-33740,70686,0,-53984,113098,1,124,1
48751,585021,-632474,1298,1356754,-1465890,1046,130,0
107,25,-133,-1,2976,-15397,-1,124,1
11,116,-127,0,13461,-14742,0,124,1
1074490,-394565,-679926,-1,-593437,-1020970,-2,130,0
-47452,950985,-904184,-651,1449132,-1377283,837,130,0
-689676,479717,212557,2598,1107691,485976,836,130,0
-785230,-239209,1029638,5199,-366159,1561828,627,130,0
804080,96853,-901584,-651,158780,-1486628,627,130,0
-641575,-436817,1083590,5198,-659002,1623832,208,130,0
5040,-4744,-296,0,-13698,-854,1,124,1
77352,-338663,263259,1948,-1557849,1204467,-212,130,0
-52,-547,599,0,-1037,1136,1,124,1
-1072541,497918,579171,4548,755777,876852,1465,130,0
-42252,-94904,140405,3249,-1089887,1598486,-630,130,0
399,-546,146,-1,-15777,4227,-1,124,1
109146,130940,-240086,0,169451,-310700,-1,124,1
-216,-344,560,0,-9943,16194,1,124,1
-312012,1054989,-742978,-1,1590316,-1119632,836,130,0
550,-160,-389,1,-4639,-11243,0,124,1
928234,-956836,31851,3249,-1437612,46712,-421,130,0
126754,-120255,-5851,648,-1370371,-85256,-840,130,0
-35102,-910685,950985,5198,-1385872,1442219,-2,130,0
1051739,-648725,-402366,648,-998976,-619621,-421,130,0
-129355,17550,114404,2599,214500,1294960,628,130,0
452416,242459,-695527,-652,561805,-1608751,207,130,0
56124,-230515,174391,0,-298314,225683,0,124,1
-304212,-2601,309411,2598,-12569,1420643,417,130,0
230108,-695527,467367,1948,-1602885,1075013,-839,130,0
130654,-988688,861932,3898,-1502758,1306900,-420,130,0
-935386,13650,927584,5848,18643,1405771,1256,130,0
386114,594772,-981537,-651,982217,-1620900,627,130,0
-352964,156655,196957,648,726032,904293,836,130,0
36401,910684,-946436,649,1387128,-1440335,1255,130,0
-1084241,583071,504418,3248,876433,755986,1255,130,0
-848282,-17551,867782,1949,-31212,1430070,418,130,0
1062789,-350364,-713077,-652,-529966,-1073129,-211,130,0
30000,30000,30000,90000,60000,60000,180000,124,1
-822281,989987,-165107,2599,1526427,-257442,1465,130,0
-313962,-655875,970486,649,-1083393,1600580,-211,130,0
255459,-564872,310711,1298,-1630745,898847,-210,130,0
204988,6293,-211281,0,8144,-273423,0,124,1
9899,-4949,-4949,1,-14142,-14142,0,124,1
-70710,35355,35355,0,56568,56568,-1,124,1
52,547,-599,0,1037,-1136,-1,124,1
-141313,-97786,239099,0,-126546,309422,1,124,1
-344513,105303,241159,1949,490375,1103711,208,130,0
564221,-247660,-317862,-1301,-713046,-916234,-630,130,0
-256,564,-308,0,16311,-8896,0,124,1
-839832,873632,-35102,-1302,1443895,-58862,1465,130,0
408865,294461,-702677,649,681833,-1625927,837,130,0
550,-389,-160,1,-11243,-4639,0,124,1
77352,-338013,263259,2598,-1557220,1206353,-839,130,0
0,0,0,0,0,0,0,124,1
7527,-9331,1804,0,-26661,5154,0,124,1
334112,-1063440,731927,2599,-1597020,1097636,-421,130,0
639623,-976987,337362,-2,-1608751,557197,-421,130,0
-81904,139105,-55253,1948,1625298,-667590,836,130,0
-5500,3893,1606,-1,11243,4639,0,124,1
-823581,1024438,-200858,-1,1542347,-303736,1465,130,0
1144,147,-1291,0,1707,-14922,-1,124,1
0,0,0,0,0,0,0,124,1
-52002,138455,-85154,1299,1618804,-999185,627,130,0
533019,134555,-668226,-652,313790,-1544443,627,130,0
171606,-553821,382864,649,-1594926,1103083,-421,130,0
843081,-874283,33151,1949,-1441173,54462,-421,130,0
-770929,-274961,1052389,6499,-415385,1575863,627,130,0
-68756,20082,48674,0,32132,77878,-1,124,1
-252860,563571,-311362,-651,1630954,-899895,837,130,0
-32101,70613,-38511,1,112982,-61618,1,124,1
-341913,246359,96203,649,1146444,434865,1047,130,0
0,0,0,0,0,0,0,124,1
-291211,564221,-271711,1299,1633677,-788246,837,130,0
-245060,341912,-95554,1298,1585498,-450367,1255,130,0
165106,761178,-928235,-1951,1257883,-1531246,836,130,0
-457618,-619474,1082290,5198,-936134,1627602,208,130,0
332162,-563572,232708,1298,-1625718,671988,-420,130,0
-598023,-26001,627273,3249,-63052,1444942,627,130,0
56124,174391,-230515,0,225683,-298314,0,124,1
0,0,0,0,0,0,0,124,1
979586,-875583,-102704,1299,-1329943,-156686,-2,130,0
740377,315911,-1055640,648,472570,-1589898,627,130,0
642,-1412,770,0,-16311,8896,0,124,1
-33802,-287961,324362,2599,-1329524,1486837,208,130,0
0,0,0,0,0,0,0,124,1
-326313,704626,-376365,1948,1632630,-874339,1466,130,0
-707227,-246360,954885,1298,-408053,1573768,208,130,0
-841132,-154706,1001037,5199,-237333,1518467,836,130,0
575921,-987387,411465,-1,-1626556,679319,-421,130,0
986736,-104654,-881434,648,-161294,-1326800,-1,130,0
-485569,-9751,495968,648,-29117,1429232,837,130,0
156137,80252,-236390,-1,103856,-305917,-1,124,1
521969,-451767,-68903,1299,-1304387,-199837,-630,130,0
-599973,-455018,1059539,4548,-703619,1628231,209,130,0
495968,590872,-1084891,1949,886278,-1631164,417,130,0
-1006238,144305,864532,2599,214709,1294960,627,130,0
-223609,-785880,1011437,1948,-1211591,1554496,-421,130,0
-211908,1015988,-804081,-1,1548631,-1224787,1256,130,0
59802,885983,-945786,-1,1366809,-1457721,627,130,0
156655,-353614,200207,3248,-1629698,914976,-421,130,0
756628,171606,-929535,-1301,281740,-1533550,836,130,0
-92003,-146356,238359,0,-189402,308465,0,124,1
30000,30000,30000,90000,60000,60000,180000,124,1
-20801,-110505,133905,2599,-1269196,1524961,-211,130,0
1033538,-811881,-221009,648,-1218922,-332643,-420,130,0
919134,-921735,4550,1949,-1417083,4608,-630,130,0
880782,109854,-990638,-2,163179,-1488723,418,130,0
-572672,983486,-412116,-1302,1626764,-680996,836,130,0
55902,83853,-138456,1299,989130,-1620062,209,130,0
494668,189157,-683826,-1,439473,-1581938,-1,130,0
1036788,-709827,-327613,-652,-1092820,-505458,-840,130,0
-482,497,-14,1,14354,-427,0,124,1
-37052,955535,-919135,-652,1441800,-1386081,1046,130,0
-174207,-840482,1018588,3899,-1265006,1527684,-211,130,0
968536,-110505,-856083,1948,-173025,-1319888,-211,130,0
-1059540,313311,747528,1299,467543,1121516,418,130,0
-1306,184,1121,-1,2132,12958,0,124,1
331512,-564222,233358,648,-1625927,674292,-420,130,0
-1026389,276910,750778,1299,425020,1153566,837,130,0
0,0,0,0,0,0,0,124,1
343862,-248960,-94254,648,-1143931,-438217,-630,130,0
-254,-404,658,0,-766,1247,0,124,1
1082940,-617524,-464768,648,-928383,-699430,-1,130,0
-1025739,822930,204757,1948,1237774,304573,1046,130,0
92303,436816,-527820,1299,1265633,-1527266,1045,130,0
-982187,888583,96853,3249,1338530,142441,1465,130,0
35101,-136506,104003,2598,-1565390,1187500,-840,130,0
278210,770278,-1046540,1948,1159012,-1575864,1464,130,0
-991938,505068,486218,-652,833072,800604,836,130,0
-1375,401,973,-1,4639,11243,0,124,1
-759879,-169657,930834,1298,-281951,1534387,627,130,0
886633,-61753,-824881,-1,-103689,-1359269,208,130,0
-366614,-689026,1060839,5199,-1049459,1608959,207,130,0
902883,-975037,74752,2598,-1467776,112277,-211,130,0
-205,650,-444,1,1231,-842,1,124,1
90353,892483,-982187,649,1341672,-1477621,836,130,0
805380,92953,-900284,-1951,153334,-1484324,837,130,0
-1069941,704626,365963,648,1058674,548399,1255,130,0
-1085541,492068,595422,1949,738391,892772,837,130,0
0,0,0,0,0,0,0,124,1
-62403,640273,-577222,648,1482647,-1335179,1465,130,0
33,-135,102,0,-15661,11848,0,124,1
-588923,-392615,984786,3248,-649785,1622784,-2,130,0
-1035489,233358,806680,4549,347934,1208028,627,130,0
-707877,347113,362713,1949,801023,832653,1255,130,0
-913285,964636,-48752,2599,1452064,-77296,1046,130,0
-5656,2828,2828,0,8167,8167,0,124,1
-220359,-787830,1009487,1298,-1214523,1553030,-1,130,0
-843732,-132605,980236,3899,-207378,1506737,628,130,0
-1046540,273660,776129,3249,409938,1164877,1465,130,0
-205,-444,650,1,-842,1231,1,124,1
-701377,1068640,-364014,3249,1607283,-550285,627,130,0
450466,-1080341,633123,3248,-1625927,952681,-211,130,0
-43552,-588923,634423,1948,-1359688,1464004,-2,130,0
256,308,-564,0,8896,-16311,0,124,1
284060,-327613,44851,1298,-1504643,201093,-211,130,0
804080,96853,-901584,-651,157942,-1486209,837,130,0
-976987,629873,347763,649,1040241,571022,836,130,0
-254,658,-404,0,1247,-766,0,124,1
-132605,-862583,1001037,5849,-1302083,1505689,208,130,0
-422516,700726,-275611,2599,1622365,-642244,1255,130,0
-20801,-928235,953585,4549,-1397393,1431326,-2,130,0
205407,809280,-1014038,649,1232956,-1544024,1255,130,0
301611,-1044590,746877,3898,-1586128,1132828,-421,130,0
-646,188,457,-1,357,866,0,124,1
-793030,1036138,-241160,1948,1562037,-364902,1674,130,0
-1035489,230108,807980,2599,344582,1210752,837,130,0
-988688,433566,555770,648,714301,915186,836,130,0
-707877,-244410,954885,2598,-405749,1572930,-1,130,0
67602,-888584,821630,648,-1466938,1355916,-2,130,0
30000,30000,30000,90000,60000,60000,180000,124,1
354263,-1043290,692275,3248,-1605609,1063702,-421,130,0
-64,-77,141,0,-8896,16311,0,124,1
650024,-85804,-565522,-1302,-195857,-1306272,-210,130,0
-989338,827481,164456,2599,1273803,249691,1465,130,0
297711,267160,-564872,-1,773373,-1632212,627,130,0
-118305,-863233,986736,5198,-1314442,1497310,-2,130,0
522,-73,-448,1,-2132,-12958,0,124,1
1034188,-261310,-770929,1949,-397999,-1172838,-211,130,0
11,116,-127,0,13461,-14742,0,124,1
35101,286660,-319812,1949,1330570,-1485371,837,130,0
1024438,-276911,-747529,-2,-427115,-1151472,-211,130,0
136505,-30552,-103354,2599,-341650,-1212219,-1,130,0
-738,-674,1413,1,-7793,16328,1,124,1
-541,-860,1402,1,-9943,16194,1,124,1
-408866,-295762,705926,1298,-684767,1626345,-2,130,0
-81254,139105,-55903,1948,1625717,-670523,1255,130,0
8820,-518,-8302,0,-1480,-23721,0,124,1
737127,320462,-1056290,1299,479692,-1591574,417,130,0
256759,-565522,310711,1948,-1631374,895705,-839,130,0
-536921,422515,114404,-2,1222482,327824,836,130,0
-92003,238359,-146356,0,308465,-189402,0,124,1
-841132,-170957,1017938,5849,-259537,1526217,417,130,0
74292,-235162,160869,-1,-304328,208184,-1,124,1
-165757,1012087,-846332,-2,1523075,-1272757,836,130,0
566821,-1088791,523919,1949,-1633678,786360,-420,130,0
-770279,-278861,1052389,3249,-420203,1576910,417,130,0
962686,-289261,-674726,-1301,-478855,-1112929,-420,130,0
-445917,-620774,1072540,5849,-946817,1626345,208,130,0
-824231,1024438,-198908,1299,1541718,-301851,1464,130,0
889883,53301,-942536,648,80018,-1452275,417,130,0
0,0,0,0,0,0,0,124,1
-3251,-488819,492718,648,-1409542,1420015,-420,130,0
139105,-98804,-39002,1299,-1127383,-460212,-630,130,0
-432917,-98804,532369,648,-285721,1535853,627,130,0
-789780,1023788,-232059,1949,1559105,-356104,1256,130,0
50051,-953586,908084,4549,-1449551,1377282,208,130,0
787179,242459,-1026389,3249,366158,-1561200,628,130,0
-1046540,358813,687725,-2,551751,1055532,836,130,0
662,-286,-376,0,-541,-712,1,124,1
273660,55902,-330213,-651,265820,-1528104,417,130,0
-1085541,492718,594772,1949,739648,891515,837,130,0
174,-553,378,-1,-15977,10929,-1,124,1
1034838,-230109,-804081,648,-348144,-1207820,-211,130,0
-615574,1079690,-463468,648,1628440,-699011,1046,130,0
-375065,1056939,-681876,-2,1611263,-1038776,1045,130,0
-363364,-342563,708526,2599,-794949,1633049,-1,130,0
-637674,972436,-336063,-1301,1608750,-556360,837,130,0
-1073191,570071,507669,4549,866169,766879,1255,130,0
256,-564,308,0,-16311,8896,0,124,1
155,-637,482,0,-1206,912,-1,124,1
9868,-5607,-4261,0,-16020,-12176,1,124,1
-505069,679275,-171607,2599,1572720,-401560,1464,130,0
-125617,240333,-114716,0,311020,-148456,1,124,1
30000,30000,30000,90000,60000,60000,180000,124,1
1375,-973,-401,1,-11243,-4639,0,124,1
-106604,-26001,135205,2600,-297242,1539414,417,130,0
174,378,-553,-1,10929,-15977,-1,124,1
545370,-665625,120904,649,-1533131,277341,-421,130,0
646,-457,-188,1,-866,-357,0,124,1
-172257,677975,-505719,-1,1572301,-1171162,1255,130,0
1054339,-430317,-622724,1298,-664657,-959804,-420,130,0
-663675,1073190,-407566,1949,1618595,-615641,1255,130,0
313961,-301612,-9751,2598,-1387757,-53416,-839,130,0
-214212,12582,201630,0,16283,260933,0,124,1
-109146,-130940,240086,0,-169451,310700,1,124,1
414715,-1078391,666924,3248,-1619015,998765,-421,130,0
103353,552520,-655875,-2,1280925,-1518049,1046,130,0
-470,-172,642,0,-325,1215,0,124,1
263259,435516,-698127,648,1009867,-1616501,417,130,0
-204988,-6293,211281,0,-8144,273423,0,124,1
593472,480367,-1072541,1298,729802,-1629907,837,130,0
1032888,-263260,-770279,-651,-399674,-1171581,-1,130,0
30000,30000,30000,90000,60000,60000,180000,124,1
663024,401715,-1063440,1299,609774,-1616711,836,130,0
-839832,-173557,1017938,4549,-263727,1527893,417,130,0
-375065,705276,-328263,1948,1632839,-762691,1464,130,0
-457,-59,516,0,-1707,14922,1,124,1
1034188,-811881,-221009,1298,-1219132,-332224,-421,130,0
335412,-268461,-65653,1298,-1234214,-310230,-840,130,0
-738,-674,1413,1,-7793,16328,1,124,1
-671476,139755,532369,648,322168,1225834,627,130,0
65328,-9229,-56098,1,-14767,-89757,1,124,1
-53302,-86454,141705,1949,-989549,1620061,-1,130,0
-632,138,493,-1,261,935,-1,124,1
0,0,0,0,0,0,0,124,1
-782630,-258710,1045239,3899,-390667,1568740,208,130,0
1075790,-653925,-421216,649,-986198,-634703,-421,130,0
76052,66302,-138456,3898,777981,-1632421,627,130,0
30000,30000,30000,90000,60000,60000,180000,124,1
-976987,629223,348413,649,1039403,572488,1046,130,0
92953,46151,-137806,1298,544210,-1605609,208,130,0
1018588,-185257,-832682,649,-281532,-1252228,417,130,0
122854,-993238,874282,3898,-1497102,1315279,-1,130,0
1082290,-580472,-501169,649,-877272,-754521,-1,130,0
0,0,0,0,0,0,0,124,1
74292,160869,-235162,-1,208184,-304328,-1,124,1
-27059,70105,-43045,1,112169,-68873,1,124,1
23400,-317862,296411,1949,-1463167,1360734,-211,130,0
30000,30000,30000,90000,60000,60000,180000,124,1
-824231,1025088,-199558,1299,1542137,-302689,1464,130,0
-141056,68902,71502,-652,817362,816315,1046,130,0
802780,97503,-901584,-1301,160037,-1487257,417,130,0
-328913,52001,278210,1298,242569,1277573,627,130,0
7800,301611,-306162,3249,1400953,-1427976,1046,130,0
0,0,0,0,0,0,0,124,1
-6999,9562,-2562,1,27320,-7320,1,124,1
-119605,662374,-542121,648,1533759,-1253695,1465,130,0
-1344,1050,294,0,12138,3396,0,124,1
-737778,-317212,1060189,5199,-479693,1592201,417,130,0
-501819,474517,27301,-1,1374769,77504,1255,130,0
-570072,-516770,1088790,1948,-777773,1632630,-2,130,0
139755,839181,-978937,-1,1294331,-1510089,1046,130,0
839181,175506,-1014689,-2,262888,-1527266,418,130,0
237456,-151298,-86157,1,-195798,-111497,1,124,1
120254,862582,-982837,-1,1315069,-1496054,1256,130,0
-1748,5533,-3785,0,15977,-10929,1,124,1
-328913,51351,278860,1298,238589,1280087,627,130,0
709826,-1040039,332162,1949,-1599534,510484,-840,130,0
689025,-1073191,388064,3898,-1613150,581496,-839,130,0
0,0,0,0,0,0,0,124,1
354263,-159256,-193708,1299,-727709,-902409,-212,130,0
48101,-952286,909384,5199,-1448085,1379168,208,130,0
338012,725427,-1062790,649,1088839,-1598487,627,130,0
-130,18,112,0,2132,12958,0,124,1
534320,-1076441,545370,3249,-1634097,826788,-211,130,0
4823,-4971,148,0,-14354,427,0,124,1
-607123,615573,-7151,1299,1425671,-21157,1465,130,0
-139106,89053,52001,1948,1034166,577935,627,130,0
130,-18,-112,0,-2132,-12958,0,124,1
-120,124,-3,1,14354,-427,0,124,1
1033538,-261960,-770279,1299,-399255,-1171791,-1,130,0
-239675,136173,103501,-1,176224,133943,0,124,1
1060189,-507670,-551221,1298,-784266,-848574,-420,130,0
9868,-4261,-5607,0,-12176,-16020,1,124,1
-98804,135205,-36402,-1,1579843,-429420,836,130,0
-221,-1099,1320,0,-12694,15249,0,124,1
354263,-159256,-193708,1299,-730013,-900733,-630,130,0
-118955,-3901,125454,2598,-42523,1435097,209,130,0
254,404,-658,0,766,-1247,0,124,1
-1396,889,506,-1,10279,5853,-1,124,1
1320,-5423,4103,0,-15661,11848,0,124,1
44,-510,466,0,-14742,13461,0,124,1
-541,1402,-860,1,16194,-9943,1,124,1
926934,27951,-954236,649,40218,-1434051,207,130,0
206057,-352964,150805,3898,-1627394,688536,-421,130,0
431,221,-653,-1,420,-1237,0,124,1
-463468,691625,-227509,648,1603303,-529338,1045,130,0
-256760,-785880,1043939,1299,-1182683,1567484,-1,130,0
-1032239,263259,774829,5849,397579,1173884,1465,130,0
399764,-547971,150155,1948,-1579844,430047,-421,130,0
-541,-860,1402,1,-9943,16194,1,124,1
-776,-8158,8935,1,-23309,25528,0,124,1
986736,-432917,-554471,-652,-715350,-913720,-1,130,0
-484269,-9751,496618,2598,-30793,1429651,418,130,0
-165757,-187858,355563,1948,-866798,1632211,-210,130,0
1076440,-410166,-665625,649,-618154,-999814,208,130,0
4576,-5167,591,0,-14922,1707,-1,124,1
-848282,-16251,867782,3249,-29955,1429232,418,130,0
1344,-294,-1050,0,-3396,-12138,0,124,1
-289911,1048489,-757279,1299,1582356,-1143093,1046,130,0
919134,-921085,3250,1299,-1416664,3561,-839,130,0
-1033539,768328,271710,6499,1166553,407633,1255,130,0
9777,-6229,-3547,1,-17799,-10136,1,124,1
5172,4723,-9896,-1,13496,-28274,0,124,1
-939936,919134,22750,1948,1399696,30792,1884,130,0
1059539,-577872,-479718,1949,-891097,-739858,-420,130,0
786529,243109,-1027039,2599,368252,-1561619,627,130,0
172256,843081,-1014689,648,1267519,-1525800,1046,130,0
565,-282,-282,1,-8167,-8167,0,124,1
576571,-987387,410815,-1,-1626346,678272,-211,130,0
529119,530419,-1060190,-652,816943,-1632840,1046,130,0
35101,910034,-945786,-651,1387337,-1440125,1255,130,0
523919,-77353,-447217,-651,-222042,-1290143,-212,130,0
-1053040,647424,408215,2599,995204,624857,1465,130,0
547970,-1086841,542120,3249,-1633887,814429,-420,130,0
-332813,1060839,-728028,-2,1597438,-1095333,627,130,0
457,-516,59,0,-14922,1707,-1,124,1
960735,-689676,-271711,-652,-1137437,-446806,-839,130,0
-237456,86157,151298,-1,111497,195798,-1,124,1
637673,-1082941,448516,3248,-1625718,673035,-211,130,0
-1070591,702026,369213,648,1054904,553217,1046,130,0
676675,-519370,-156006,1299,-1198813,-361760,-421,130,0
383514,597372,-981537,-651,985568,-1620481,627,130,0
137,-97,-40,0,-11243,-4639,0,124,1
-1375,401,973,-1,4639,11243,0,124,1
139755,-41602,-96204,1949,-467125,-1121936,-421,130,0
41562,28760,-70323,-1,46016,-112517,-1,124,1
-512870,-569422,1086840,4548,-858210,1632630,418,130,0
1060839,-328913,-730628,1298,-495822,-1099942,-421,130,0
-496619,-588923,1087490,1948,-886070,1631373,208,130,0
-1034839,231408,807980,4549,345210,1210333,1046,130,0
139105,-41602,-96204,1299,-469010,-1120679,-420,130,0
530419,528469,-1058890,-2,813801,-1632840,837,130,0
-287961,1048489,-758579,1949,1581518,-1144769,626,130,0
999087,-191758,-806031,1298,-297033,-1241964,-2,130,0
218408,810580,-1028339,649,1221225,-1549889,1046,130,0
-234009,-112455,348413,1949,-517608,1600161,-421,130,0
-140406,60452,81253,1299,709065,920213,1046,130,0
213858,813180,-1027039,-1,1224577,-1548213,837,130,0
-962037,688375,273660,-2,1135760,449528,836,130,0
-844382,995837,-149506,1949,1515953,-229583,1464,130,0
-52002,139105,-85154,1949,1619433,-998138,1046,130,0
-315262,-654575,970486,649,-1082346,1600580,-421,130,0
694226,-960736,266509,-1,-1582567,439892,-421,130,0
35101,286660,-319812,1949,1330361,-1486000,837,130,0
-5587,3559,2027,-1,10279,5853,-1,124,1
30000,30000,30000,90000,60000,60000,180000,124,1
-428367,532369,-104654,-652,1542556,-304364,1046,130,0
289910,-1049140,763778,4548,-1580472,1148119,-211,130,0
-454368,516769,-62403,-2,1497520,-182451,1256,130,0
-201508,351663,-148856,1299,1627602,-691260,836,130,0
-689026,481668,209957,2599,1112299,480111,836,130,0
1026388,-823581,-201508,1299,-1238612,-303317,-629,130,0
-5500,3893,1606,-1,11243,4639,0,124,1
336712,727377,-1062790,1299,1091562,-1597858,837,130,0
30000,30000,30000,90000,60000,60000,180000,124,1
938635,-742328,-197608,-1301,-1224368,-324264,-210,130,0
-848932,-15601,867132,2599,-27651,1428184,417,130,0
1051739,-645475,-404966,1298,-994996,-624648,-630,130,0
642,-1412,770,0,-16311,8896,0,124,1
-351014,1040688,-689026,648,1605817,-1063703,836,130,0
2568,-5649,3080,-1,-16311,8896,0,124,1
0,-122,122,0,-14145,14145,0,124,1
155,-637,482,0,-1206,912,-1,124,1
1019888,-189808,-829432,648,-288235,-1248039,-2,130,0
1083590,-583722,-499219,649,-880624,-750960,-2,130,0
-532370,-525870,1062789,4549,-813802,1633468,-1,130,0
-733228,1045239,-309412,2599,1591364,-474456,1256,130,0
-1144,1291,-147,0,14922,-1707,1,124,1
-9625,6814,2811,0,19469,8033,0,124,1
723477,339962,-1062140,1299,509228,-1598277,418,130,0
254,-658,404,0,-1247,766,0,124,1
-666925,1072540,-404316,1299,1617757,-610613,1256,130,0
579171,-644175,65652,648,-1483696,149772,-212,130,0
379614,-707877,330862,2599,-1632631,760595,-421,130,0
-126755,347763,-219709,1299,1615243,-1019714,836,130,0
-176807,-377015,554470,648,-1088421,1598905,-630,130,0
130654,-542771,412115,-2,-1564552,1189595,-420,130,0
204988,6293,-211281,0,8144,-273423,0,124,1
1084890,-564872,-520670,-652,-850669,-782381,-420,130,0
-4494,-5391,9885,0,-15404,28245,1,124,1
-81904,139105,-56553,648,1625508,-669056,1256,130,0
-590873,-391315,984136,1948,-648737,1622575,-1,130,0
1069290,-701377,-367914,-1,-1053648,-554475,-630,130,0
545370,-664325,120904,1949,-1532712,276503,-211,130,0
88,-528,439,-1,-15249,12694,0,124,1
-521320,450466,71502,648,1302082,204235,1255,130,0
1144,147,-1291,0,1707,-14922,-1,124,1
468667,-694877,230108,3898,-1602885,527033,-420,130,0
30000,30000,30000,90000,60000,60000,180000,124,1
90353,250259,-339963,649,1165506,-1573769,837,130,0
-3673,5562,-1888,1,16060,-5452,0,124,1
598672,26000,-623374,1298,60537,-1443477,417,130,0
492718,190457,-684476,-1301,443034,-1582567,417,130,0
867782,-1002988,136505,1299,-1506109,204445,-630,130,0
114,-129,14,-1,-14922,1707,-1,124,1
-566,584,-17,1,1106,-32,1,124,1
-917835,917834,1950,1949,1415197,-419,1256,130,0
-223609,944485,-722178,-1302,1563504,-1192529,1046,130,0
-1020539,190457,833331,3249,284882,1250551,836,130,0
999737,-191758,-805381,2598,-298290,-1241336,-2,130,0
1060839,-507019,-551871,1949,-783638,-849203,-421,130,0
-228649,178664,49985,0,231212,64686,-1,124,1
1004287,-866483,-137156,648,-1299988,-206960,-211,130,0
131954,-20151,-111155,648,-216176,-1293704,208,130,0
-720878,-339963,1066039,5198,-514256,1599742,208,130,0
-63003,59302,3700,-1,94884,5921,0,124,1
-6999,9562,-2562,1,27320,-7320,1,124,1
-48102,-912635,963986,3249,-1376446,1450179,-2,130,0
-932785,29901,905483,2599,43779,1392155,417,130,0
523269,-451117,-70853,1299,-1301035,-205493,-629,130,0
504,-29,-474,1,-854,-13698,1,124,1
-107255,965286,-858683,-652,1490188,-1324915,1255,130,0
85153,55252,-138456,1949,657744,-1623204,209,130,0
181356,-354914,175506,1948,-1633887,805422,-420,130,0
-537,-69,607,1,-131,1149,0,124,1
-927585,-24051,956835,5199,-39591,1434050,627,130,0
5226,-4487,-738,1,-12958,-2132,0,124,1
330862,-707877,378964,1949,-1632631,873082,-630,130,0
-9414,2058,7356,0,5880,21019,0,124,1
-665625,1060839,-392615,2599,1616291,-600140,1674,130,0
0,0,0,0,0,0,0,124,1
22,-132,109,-1,-15249,12694,0,124,1
128054,-9101,-116355,2598,-85675,-1369323,208,130,0
70492,-30441,-40050,1,-48706,-64081,1,124,1
-1320,-4103,5423,0,-11848,15661,0,124,1
656,-238,-418,0,-451,-792,0,124,1
-178107,-375715,554470,648,-1083184,1600371,-421,130,0
637023,-977637,340612,-2,-1609589,562015,-630,130,0
128054,-9101,-117005,1948,-89864,-1367229,-1,130,0
-386115,-595423,982836,1298,-983684,1621109,-420,130,0
-378315,-687726,1071890,5849,-1039613,1611054,-210,130,0
367913,185256,-556421,-3252,538135,-1604561,-211,130,0
-124805,117654,8450,1299,1372883,81065,1254,130,0
-71503,139755,-66303,1949,1633677,-784685,1465,130,0
30000,30000,30000,90000,60000,60000,180000,124,1
-138456,89053,52001,2598,1033957,578354,837,130,0
392614,-1073841,683175,1948,-1614197,1025997,-211,130,0
61752,-968537,910034,3249,-1458349,1366809,-420,130,0
-746878,934735,-188508,-651,1545280,-312324,1256,130,0
-21850,69165,-47314,1,110664,-75703,0,124,1
-536921,422515,114404,-2,1223111,326777,1046,130,0
-1077741,414065,665624,1948,622343,996671,628,130,0
57206,7391,-64597,0,11826,-103355,0,124,1
-962037,686425,274310,-1302,1134294,451832,1255,130,0
840481,175506,-1014689,1298,262469,-1526847,837,130,0
959435,-874283,-82554,2598,-1346700,-127988,-839,130,0
-176807,351663,-172907,1949,1633677,-806261,836,130,0
30000,30000,30000,90000,60000,60000,180000,124,1
-536921,421865,115704,648,1219968,331595,1255,130,0
-64,141,-77,0,16311,-8896,0,124,1
936035,-8451,-924335,3249,-15292,-1406400,418,130,0
-1051090,767028,285360,1298,1153356,425439,837,130,0
0,-489,489,0,-14145,14145,0,124,1
484268,11050,-496619,-1301,33934,-1431118,-211,130,0
-457,516,-59,0,14922,-1707,1,124,1
-703327,1067990,-362714,1949,1606864,-547143,1046,130,0
614,-527,-86,1,-998,-164,0,124,1
85153,-142356,59802,2599,-1625509,669265,-840,130,0
353613,-207358,-146256,-1,-947655,-678483,-421,130,0
-234659,-111805,348413,1949,-517608,1600161,-212,130,0
339312,725427,-1062790,1949,1089676,-1598487,836,130,0
8440,259,-8699,0,740,-24856,0,124,1
632,-138,-493,1,-261,-935,1,124,1
-1084241,492068,595422,3249,739229,892144,1047,130,0
9625,-2811,-6814,0,-8033,-19469,0,124,1
-1025739,822280,206057,2598,1237355,305411,1047,130,0
9414,-7356,-2058,0,-21019,-5880,0,124,1
748178,-937986,189807,-1,-1545490,314209,-211,130,0
-1006238,180706,831381,5849,272314,1258930,1046,130,0
476467,-1083591,611022,3898,-1629698,918118,-630,130,0
600622,455667,-1056940,-651,700686,-1627813,627,130,0
182656,-354914,174856,2598,-1633887,801651,-630,130,0
-20151,130654,-109205,1298,1523913,-1271709,627,130,0
68756,-48674,-20082,0,-77878,-32132,1,124,1
-311362,299011,14950,2599,1385242,58233,1255,130,0
-24051,-927585,954235,2599,-1395926,1433002,-211,130,0
-273011,-58503,334112,2598,-269801,1529988,627,130,0
30000,30000,30000,90000,60000,60000,180000,124,1
-110,1276,-1165,1,14742,-13461,0,124,1
-522,448,73,-1,12958,2132,0,124,1
26000,926284,-952286,-2,1394459,-1433841,836,130,0
1055639,-433567,-620124,1948,-670104,-954568,-2,130,0
-674726,520019,156655,1948,1202373,356941,1256,130,0
68756,-20082,-48674,0,-32132,-77878,1,124,1
879482,-835282,-44852,-652,-1377283,-72478,-629,130,0
-943186,936035,11050,3899,1408284,13615,1255,130,0
635723,-590223,-44852,648,-1359269,-105784,-839,130,0
0,0,0,0,0,0,0,124,1
-768329,1015338,-245060,1949,1566646,-381241,1255,130,0
65328,-56098,-9229,1,-89757,-14767,1,124,1
-135856,-407566,544070,648,-1177028,1569578,-2,130,0
0,0,0,0,0,0,0,124,1
0,0,0,0,0,0,0,124,1
379614,-1061490,685125,3249,-1611474,1039822,-2,130,0
700726,-439417,-260660,649,-1012382,-603910,-420,130,0
-509620,987386,-479718,-1952,1633677,-792645,837,130,0
-85154,525219,-441367,-1302,1522656,-1273804,1045,130,0
1033538,-228159,-805381,-2,-344164,-1210334,208,130,0
-53302,-87104,141055,649,-991435,1619642,-421,130,0
-349714,132604,219708,2598,615849,1002326,626,130,0
-705277,296411,410815,1949,683718,943255,1046,130,0
-1396,889,506,-1,10279,5853,-1,124,1
458267,529119,-988038,-652,875176,-1631583,627,130,0
939935,-742978,-196308,649,-1225416,-322798,-421,130,0
-228649,178664,49985,0,231212,64686,-1,124,1
-742328,-312012,1058889,4549,-472571,1590735,627,130,0
30000,30000,30000,90000,60000,60000,180000,124,1
5040,-296,-4744,0,-854,-13698,1,124,1
-332,-230,562,0,-6643,16244,1,124,1
-245060,341912,-96854,-2,1586127,-452671,1256,130,0
443,4661,-5105,-1,13461,-14742,0,124,1
-169999,232224,-62224,1,300525,-80525,1,124,1
-140406,-210608,353613,2599,-971325,1622784,-421,130,0
-558371,358813,200207,649,1037518,574374,837,130,0
-139,50,88,-1,5853,10279,-1,124,1
-987387,567471,420565,649,936133,691888,1046,130,0
-977637,630523,347763,649,1040660,570603,836,130,0
0,0,0,0,0,0,0,124,1
0,0,0,0,0,0,0,124,1
354263,-159906,-193058,1299,-732317,-898638,-630,130,0
-443,-4661,5105,1,-13461,14742,0,124,1
-367,556,-188,1,16060,-5452,0,124,1
-904834,-64353,973086,3899,-99919,1461909,836,130,0
-655875,555770,101403,1298,1285743,230210,1046,130,0
0,0,0,0,0,0,0,124,1
233773,-68281,-165491,1,-88364,-214165,1,124,1
-749479,1054339,-302262,2598,1587384,-457698,1256,130,0
755328,174206,-930835,-1301,286558,-1535435,208,130,0
379614,-707877,330212,1949,-1632631,759338,-630,130,0
-9751,-117655,129354,1948,-1346072,1474268,-630,130,0
-799530,-232059,1036788,5199,-351496,1557429,836,130,0
-332813,266509,68252,1948,1234213,310229,1256,130,0
139105,-99454,-39002,649,-1125707,-462516,-630,130,0
-491419,1083590,-592173,-2,1631582,-890888,1045,130,0
-502469,474517,27301,-651,1374769,77504,1046,130,0
36946,33740,-70686,0,53984,-113098,-1,124,1
120,3,-124,-1,427,-14354,0,124,1
195007,-1000388,807330,1949,-1540044,1241963,-211,130,0
-845032,995187,-147556,2599,1515325,-227697,1465,130,0
557720,-359464,-200208,-1952,-1035843,-576050,-630,130,0
-505,-121,626,0,-229,1186,0,124,1
534970,549920,-1083591,1299,827417,-1632840,837,130,0
1007537,-176157,-828132,3248,-269173,-1260188,208,130,0
142355,-81904,-58503,1948,-930897,-696707,-211,130,0
0,0,0,0,0,0,0,124,1
945785,-936036,-5851,3898,-1410171,-9427,-212,130,0
-493369,-191108,687075,2598,-442826,1582775,208,130,0
570071,516769,-1085541,1299,776305,-1632421,627,130,0
-427717,1053039,-624024,1298,1624460,-963365,1256,130,0
-445917,-621424,1072540,5199,-947027,1626345,417,130,0
85803,894433,-980237,-1,1345233,-1474479,1046,130,0
976986,-630524,-345813,649,-1040661,-570185,-420,130,0
-140,60,80,0,7032,9251,0,124,1
-971787,93603,884033,5849,139927,1339787,1046,130,0
-460868,-529120,988687,-1301,-874130,1632001,-2,130,0
-295762,1040038,-744278,-2,1585498,-1133667,836,130,0
1950,939935,-941886,-1,1413312,-1415826,837,130,0
460217,-1073191,615573,2599,-1627813,934248,208,130,0
84503,55252,-139106,649,659838,-1623414,1045,130,0
-1076441,412115,666924,2598,618572,1000232,1046,130,0
470,172,-642,0,325,-1215,0,124,1
-10401,-117005,130004,2598,-1342301,1477201,-629,130,0
11061,-66014,54952,-1,-105622,87924,0,124,1
994537,-878833,-114405,1299,-1320516,-172815,-629,130,0
-9101,126104,-115055,1948,1473849,-1346910,1045,130,0
30000,30000,30000,90000,60000,60000,180000,124,1
122204,1950,-122205,1949,34981,-1431537,-2,130,0
672775,-1065390,395214,2599,-1615873,598882,-2,130,0
105953,-345813,241809,1949,-1592412,1111671,-421,130,0
-203458,1023138,-818381,1299,1543394,-1235470,1046,130,0
300311,-315912,17550,1949,-1450389,73524,-839,130,0
-822281,990637,-165757,2599,1526846,-259118,1256,130,0
-281461,324362,-40952,1949,1502966,-196276,1256,130,0
995837,-876233,-117655,1949,-1317584,-177843,-211,130,0
-606473,615573,-8451,649,1426927,-23671,1464,130,0
646,-457,-188,1,-866,-357,0,124,1
-657175,553820,104653,1298,1282601,235028,837,130,0
943835,-211908,-731278,649,-351077,-1205935,-630,130,0
-564222,324362,240509,649,936761,691050,1046,130,0
-169999,232224,-62224,1,300525,-80525,1,124,1
-614,527,86,-1,998,164,0,124,1
-100104,-555121,657824,2599,-1284278,1516163,-211,130,0
-738,-674,1413,1,-7793,16328,1,124,1
-63053,968536,-906134,-651,1459605,-1365134,836,130,0
-451117,1067339,-615574,648,1627393,-938019,1256,130,0
0,-208206,208206,0,-269443,269443,0,124,1
-1037439,710476,330212,3249,1094285,503781,1465,130,0
1320,-5423,4103,0,-15661,11848,0,124,1
-692926,957485,-264560,-1,1581937,-436332,1046,130,0
-575922,1057589,-481669,-2,1632001,-743210,1255,130,0
505,121,-626,0,229,-1186,0,124,1
-969187,113104,859982,3899,171348,1320934,417,130,0
-440067,985436,-547321,-1952,1630744,-902828,836,130,0
30000,30000,30000,90000,60000,60000,180000,124,1
-124155,7150,119604,2599,91749,1366390,628,130,0
124804,-994538,873632,3898,-1497730,1314231,208,130,0
541,-1402,860,-1,-16194,9943,-1,124,1
305511,1950,-306162,1299,14453,-1421482,-211,130,0
-5379,4203,1176,0,12138,3396,0,124,1
329562,-707877,380264,1949,-1632421,875386,-420,130,0
247659,-344513,98803,1949,-1585709,451413,-840,130,0
-299662,-266510,566171,-1,-769184,1632420,-1,130,0
332162,-564222,232708,648,-1625718,671778,-630,130,0
-988038,108554,883383,3899,160665,1327847,1046,130,0
-1073191,570071,507018,3898,865541,767507,1255,130,0
-664325,1073190,-407566,1299,1618385,-615641,1045,130,0
-980237,365313,616873,1949,599929,1016152,837,130,0
443,-5105,4661,-1,-14742,13461,0,124,1
1086840,-546021,-541471,-652,-820086,-813383,-211,130,0
-549921,391314,158605,-2,1132199,453927,627,130,0
1054989,-432267,-621424,1298,-667799,-957081,-420,130,0
916534,-966587,52651,2598,-1452275,78342,-212,130,0
976986,-78653,-897684,649,-119400,-1350890,-2,130,0
0,0,0,0,0,0,0,124,1
-521320,449816,72152,648,1300615,206540,1255,130,0
114,-129,14,-1,-14922,1707,-1,124,1
-124805,6500,120254,1949,86302,1369113,627,130,0
-5379,4203,1176,0,12138,3396,0,124,1
-457,-59,516,0,-1707,14922,1,124,1
1260,-1186,-74,0,-13698,-854,1,124,1
171606,-553171,382864,1299,-1594926,1103083,-840,130,0
539520,-123505,-417966,-1951,-352962,-1204678,-630,130,0
-1041990,782629,262609,3248,1177027,392761,1256,130,0
1056939,-705927,-349064,1948,-1072291,-531014,-211,130,0
-1075141,391964,685775,2598,586732,1026835,627,130,0
-98804,135855,-36402,649,1579424,-427325,1256,130,0
-1075791,392614,685125,1948,588408,1025368,417,130,0
276260,770928,-1045890,1298,1161107,-1575445,1046,130,0
-112455,128054,-13651,1948,1495425,-177424,1255,130,0
-2164,-3443,5608,1,-9943,16194,1,124,1
-5172,9896,-4723,1,28274,-13496,0,124,1
-1053040,648074,407565,2599,996461,623600,1465,130,0
0,8573,-8573,0,24494,-24494,0,124,1
278210,769628,-1047190,648,1158383,-1576492,1045,130,0
-139106,89053,52001,1948,1033538,578982,837,130,0
-891184,-89054,984136,3898,-135948,1477620,627,130,0
-273011,1022488,-749479,-2,1577748,-1156290,1255,130,0
-733228,1057589,-323713,648,1594715,-488910,1255,130,0
48101,913934,-960736,1299,1377492,-1448714,1046,130,0
531719,527169,-1058890,-2,811916,-1632840,627,130,0
-884,-4396,5281,1,-12694,15249,0,124,1
239675,-103501,-136173,1,-133943,-176224,0,124,1
918,-1390,472,0,-16060,5452,0,124,1
1083590,-471918,-611673,-1,-710951,-917910,-2,130,0
5656,-2828,-2828,0,-8167,-8167,0,124,1
710476,358813,-1067340,1949,536459,-1604142,-1,130,0
109204,24050,-131305,1949,292423,-1537530,417,130,0
-783930,-256760,1045239,4549,-387944,1568112,417,130,0
-523270,1082290,-558371,649,1633677,-843128,1255,130,0
-378965,-687726,1071890,5199,-1038147,1611473,-1,130,0
738,-1413,674,-1,-16328,7793,-1,124,1
102053,554470,-655225,1298,1283858,-1516583,1046,130,0
-139756,50051,91003,1298,590922,1023483,836,130,0
-565522,247009,319161,648,713673,916024,1046,130,0
1082940,-616874,-464768,1298,-929221,-699011,-211,130,0
-82554,139105,-55903,648,1625089,-664448,1256,130,0
37051,909384,-946436,-1,1386080,-1441173,1045,130,0
-505069,1059539,-553171,1299,1633468,-852973,1256,130,0
-722828,-338663,1066689,5198,-512580,1599323,-2,130,0
399,-546,146,-1,-15777,4227,-1,124,1
0,208206,-208206,0,269443,-269443,0,124,1
5818,4026,-9845,-1,11504,-28129,0,124,1
-24051,-926935,954235,3249,-1395717,1433002,-421,130,0
438766,640924,-1077741,1949,963783,-1623623,836,130,0
170956,843731,-1014689,-2,1268776,-1525171,1046,130,0
-1548,9241,-7693,0,26405,-21981,0,124,1
-11061,-54952,66014,1,-87924,105622,0,124,1
-627924,30551,599972,2599,67240,1379587,627,130,0
-1084891,618173,469317,2599,927335,701314,1046,130,0
91,47,-139,-1,5452,-16060,0,124,1
-705277,393914,312661,1298,910787,719329,1256,130,0
-204988,211281,-6293,0,273423,-8144,0,124,1
-113105,-14951,131304,3248,-165274,1489769,418,130,0
-275611,-770279,1049139,3249,-1160270,1576072,-211,130,0
5379,-4203,-1176,0,-12138,-3396,0,124,1
-662,376,286,0,712,541,-1,124,1
33801,101403,-133906,1298,1183939,-1566228,1255,130,0
-74292,235162,-160869,1,304328,-208184,1,124,1
93603,46151,-137806,1948,544419,-1605609,208,130,0
140,-80,-60,0,-9251,-7032,0,124,1
-1006238,178756,832681,5199,269591,1260816,1046,130,0
30000,30000,30000,90000,60000,60000,180000,124,1
-646,457,188,-1,866,357,0,124,1
-22,132,-109,1,15249,-12694,0,124,1
431,-653,221,-1,-1237,420,0,124,1
-4576,5167,-591,0,14922,-1707,1,124,1
-391965,1071240,-678626,649,1614824,-1022437,1255,130,0
2310,7180,-9491,-1,20516,-27119,-1,124,1
964636,-291211,-674076,-651,-481997,-1110625,-630,130,0
-365314,555770,-190458,-2,1608121,-552171,1255,130,0
77352,-338013,263259,2598,-1557220,1206353,-629,130,0
505718,-35752,-471918,-1952,-97615,-1362830,208,130,0
-886634,61752,828131,3249,99080,1362619,836,130,0
30000,30000,30000,90000,60000,60000,180000,124,1
457617,-519370,62402,649,-1497102,182241,-630,130,0
130654,-351014,222958,2598,-1615454,1019713,-630,130,0
-686426,193707,494668,1949,446176,1137646,836,130,0
689025,-1073191,388064,3898,-1613150,582124,-421,130,0
146905,-921735,775479,649,-1519725,1278830,-211,130,0
-221,1320,-1099,0,15249,-12694,0,124,1
436816,642224,-1077741,1299,966297,-1623204,627,130,0
592,-557,-34,1,-1055,-65,1,124,1
938635,-742978,-196308,-651,-1224997,-323636,-630,130,0
-505,-121,626,0,-229,1186,0,124,1
330862,-707227,379614,3249,-1632631,872034,-840,130,0
-6429,-3304,9733,0,-9441,27810,0,124,1
30000,30000,30000,90000,60000,60000,180000,124,1
-81904,139105,-55903,1298,1625298,-667171,836,130,0
55252,83853,-138456,649,991643,-1619643,627,130,0
880782,111804,-991938,648,166530,-1490189,417,130,0
601272,456967,-1056940,1299,701733,-1627813,417,130,0
75402,-143006,68902,1298,-1633259,781752,-420,130,0
5547,-63822,58274,-1,-102115,93239,0,124,1
704626,-1071891,369213,1948,-1607913,553217,-211,130,0
-305512,-725428,1034188,3248,-1120260,1589478,-211,130,0
-592,557,34,-1,1055,65,-1,124,1
-689676,480367,209957,648,1111462,481368,1256,130,0
229458,-694877,466717,1298,-1602676,1075432,-630,130,0
50701,911984,-962037,648,1375397,-1450599,1046,130,0
1034188,-809281,-224259,648,-1215361,-337461,-1,130,0
239675,-136173,-103501,1,-176224,-133943,0,124,1
-430,533,-103,0,15397,-2976,1,124,1
2955,2699,-5654,0,7793,-16328,-1,124,1
30000,30000,30000,90000,60000,60000,180000,124,1
-446567,1077090,-629874,649,1626136,-949959,1256,130,0
30000,30000,30000,90000,60000,60000,180000,124,1
335412,-268461,-65003,1948,-1234423,-309811,-840,130,0
137,-97,-40,0,-11243,-4639,0,124,1
-573322,983486,-411466,-1302,1626555,-679739,837,130,0
-1344,1050,294,0,12138,3396,0,124,1
-275611,701376,-422516,3249,1622156,-980961,1046,130,0
-878183,993887,-113755,1949,1494168,-174072,1465,130,0
535620,549920,-1083591,1949,825741,-1632631,1255,130,0
-11,-116,127,0,-13461,14742,0,124,1
456967,531719,-988038,648,877900,-1631374,418,130,0
-292511,563571,-271711,-651,1633677,-786570,1256,130,0
1054989,-431617,-622074,1298,-666124,-958548,-421,130,0
0,0,0,0,0,0,0,124,1
-559671,206057,354263,649,593855,1020969,627,130,0
666924,380914,-1045890,1948,584638,-1612521,418,130,0
33,102,-135,0,11848,-15661,0,124,1
-891184,-51352,946435,3899,-81695,1453740,627,130,0
-1075,-257,1333,1,-2976,15397,1,124,1
5379,-4203,-1176,0,-12138,-3396,0,124,1
-237456,86157,151298,-1,111497,195798,-1,124,1
-437,-946,1383,0,-10929,15977,1,124,1
-732578,1057589,-324363,648,1594715,-489957,1046,130,0
-299012,-266510,566171,649,-769603,1632630,418,130,0
-1033539,811230,223608,1299,1219131,332642,1046,130,0
-524570,76702,447866,-2,222459,1290561,1046,130,0
-11061,-54952,66014,1,-87924,105622,0,124,1
927584,25350,-952936,-2,36448,-1432165,208,130,0
-5818,-4026,9845,1,-11504,28129,0,124,1
-284061,-752729,1041989,5199,-1147282,1581099,208,130,0
1019238,-187858,-830082,1298,-285931,-1249505,208,130,0
1064739,-352314,-710477,1948,-534784,-1069149,-211,130,0
-458918,-619474,1082290,3898,-935924,1627602,418,130,0
451116,243109,-695527,-1302,564109,-1609170,417,130,0
493368,189807,-684476,-1301,441149,-1582148,417,130,0
710476,-1039389,331512,2599,-1599115,508809,-630,130,0
-7527,-1804,9331,0,-5154,26661,0,124,1
550570,-166407,-387415,-3252,-476341,-1115024,-420,130,0
-1075791,392614,685775,2598,586942,1026625,627,130,0
-56124,-174391,230515,0,-225683,298314,0,124,1
-649375,-321763,972436,1298,-531642,1603303,-211,130,0
-522,73,448,-1,2132,12958,0,124,1
-862583,1002337,-137806,1948,1508622,-210311,1465,130,0
458917,-1072541,616873,3249,-1627813,935923,207,130,0
-750129,1053689,-302262,1298,1587384,-457489,1465,130,0
901583,-975687,76702,2598,-1468823,115000,-211,130,0
940585,-741028,-199558,-1,-1222274,-327616,-631,130,0
-530420,-527820,1062789,4549,-815897,1633258,-2,130,0
-643525,-435517,1082940,3898,-657116,1623622,208,130,0
85153,810580,-896384,-651,1339787,-1479297,836,130,0
-1006238,178756,832681,5199,269381,1261025,1255,130,0
-989338,436816,553820,1298,719538,910787,1046,130,0
960085,-923685,-34452,1948,-1387967,-52369,-631,130,0
565521,-248310,-317212,-1,-714721,-914558,-420,130,0
91,-139,47,-1,-16060,5452,0,124,1
975036,-94254,-878183,2599,-144327,-1336646,-2,130,0
-1088141,549270,542120,3249,824275,809402,1046,130,0
958135,-924985,-31202,1948,-1390690,-47551,-840,130,0
475167,-1083591,612322,3898,-1629279,919794,-211,130,0
-2310,9491,-7180,1,27119,-20516,1,124,1
5587,-3559,-2027,1,-10279,-5853,1,124,1
-368564,978286,-611023,-1301,1617548,-1007774,1046,130,0
0,0,0,0,0,0,0,124,1
-724128,-338663,1066039,3248,-511952,1599114,208,130,0
0,0,0,0,0,0,0,124,1
0,8573,-8573,0,24494,-24494,0,124,1
7527,1804,-9331,0,5154,-26661,0,124,1
-137806,-841132,981536,2598,-1296217,1509041,209,130,0
235958,109854,-344513,1299,514255,-1599534,-2,130,0
44,466,-510,0,13461,-14742,0,124,1
-596723,1069290,-470618,1949,1629906,-718701,1255,130,0
-626624,27951,600622,1949,62841,1381681,-2,130,0
-46802,-587623,635723,1298,-1356546,1466308,-212,130,0
-214509,1016638,-802131,-2,1549888,-1221855,1465,130,0
-107905,-26001,135205,1299,-291377,1537320,208,130,0
64,77,-141,0,8896,-16311,0,124,1
846981,18200,-865833,-652,28488,-1428185,-1,130,0
1026388,-824231,-199558,2599,-1240498,-300803,-630,130,0
371163,-980887,609722,-2,-1617339,1007354,-211,130,0
177456,375064,-554471,-1951,1087163,-1599115,627,130,0
76702,-338013,263259,1948,-1557220,1205934,-420,130,0
182813,43812,-226626,-1,56698,-293281,-1,124,1
-330,1355,-1025,0,15661,-11848,0,124,1
30000,30000,30000,90000,60000,60000,180000,124,1
1070590,-700727,-368564,1299,-1053858,-554265,-630,130,0
-1026389,822280,206057,1948,1237355,306039,1675,130,0
-295112,1038738,-745578,-1952,1584870,-1135761,1256,130,0
7527,1804,-9331,0,5154,-26661,0,124,1
-65328,56098,9229,-1,89757,14767,-1,124,1
44,466,-510,0,13461,-14742,0,124,1
313961,390664,-705277,-652,904084,-1629698,837,130,0
-664,332,332,0,629,629,0,124,1
559020,-208008,-352314,-1302,-597417,-1017828,-421,130,0
-189808,-163807,355563,1948,-752217,1631582,208,130,0
-827482,-193708,1026388,5198,-293053,1538157,417,130,0
1038088,-712427,-323713,1948,-1097847,-499174,-1049,130,0
850231,-1010138,161856,1949,-1520982,243407,-211,130,0
121554,2600,-123505,649,40218,-1433841,208,130,0
30000,30000,30000,90000,60000,60000,180000,124,1
-140406,69552,72152,1298,822180,811287,836,130,0
995187,-877533,-115705,1949,-1319259,-174910,-420,130,0
-63053,139755,-75403,1299,1631582,-891935,1255,130,0
131954,-113755,-16901,1298,-1297893,-209892,-1,130,0
-1320,5423,-4103,0,15661,-11848,0,124,1
-295,565,-269,1,16328,-7793,1,124,1
1056289,-704627,-351014,648,-1069778,-534156,-212,130,0
915234,-967237,53952,1949,-1453531,80228,-629,130,0
84503,-141706,59152,1949,-1625299,670522,-420,130,0
-5500,3893,1606,-1,11243,4639,0,124,1
-237456,151298,86157,-1,195798,111497,-1,124,1
-32502,-102704,137155,1949,-1182893,1566855,-211,130,0
-46802,-587623,636373,1948,-1356336,1466727,-421,130,0
-790430,1023138,-231409,1299,1558686,-355057,1046,130,0
88,439,-528,-1,12694,-15249,0,124,1
139,-50,-88,1,-5853,-10279,1,124,1
-92304,-437467,529769,-2,-1261864,1529150,208,130,0
-596723,1069290,-471268,1299,1630116,-719749,1465,130,0
4301,-5332,1030,-1,-15397,2976,-1,124,1
522,-448,-73,1,-12958,-2132,0,124,1
-330,-1025,1355,0,-11848,15661,0,124,1
-72803,-68253,142355,1299,-774840,1632420,-2,130,0
526519,-1084891,562271,3899,-1633678,845222,-211,130,0
8450,301611,-307462,2599,1399277,-1429233,836,130,0
-102054,342562,-238559,1949,1592411,-1112091,837,130,0
-410166,-294462,705926,1298,-680996,1626136,208,130,0
1056289,-705277,-349714,1298,-1071034,-532690,-211,130,0
614,-86,-527,1,-164,-998,0,124,1
122854,-992588,874282,4548,-1496683,1315488,208,130,0
192407,160556,-351014,1949,750959,-1631374,417,130,0
-889234,-74753,969836,5849,-115629,1469031,627,130,0
482,14,-497,-1,427,-14354,0,124,1
-591523,-477118,1075140,6499,-727080,1630325,627,130,0
-338013,78652,260659,1298,365948,1195670,627,130,0
570721,-1088791,521319,3249,-1633469,781333,-421,130,0
-1066690,418615,650674,2599,635540,985778,1465,130,0
1042639,-269111,-774180,-652,-407006,-1166344,-1,130,0
129354,-542121,412765,-2,-1563086,1193156,-840,130,0
-700077,438116,263259,1298,1013219,603281,1046,130,0
0,0,0,0,0,0,0,124,1
-228649,49985,178664,0,64686,231212,-1,124,1
840481,176156,-1015339,1298,263097,-1527266,836,130,0
1375,-401,-973,1,-4639,-11243,0,124,1
-991938,505068,486868,-2,831816,802070,1046,130,0
-67249,14701,52548,0,23522,84077,0,124,1
-22,-109,132,1,-12694,15249,0,124,1
0,0,0,0,0,0,0,124,1
300961,-315262,15600,1299,-1447666,68078,-630,130,0
662,-376,-286,0,-712,-541,1,124,1
668225,-1075141,410165,3249,-1618386,616478,-1,130,0
-586972,-495969,1086840,3899,-747818,1631582,208,130,0
-74103,335412,-258710,2599,1556801,-1206773,837,130,0
329562,-54603,-275611,-652,-244246,-1276318,207,130,0
-4823,-148,4971,0,-427,14354,0,124,1
-461518,-55253,516119,-652,-160876,1488093,417,130,0
30000,30000,30000,90000,60000,60000,180000,124,1
668225,-139756,-529770,-1301,-320703,-1226254,208,130,0
825530,-991938,169656,3248,-1526847,259536,-421,130,0
963986,-289261,-675376,-651,-478855,-1112719,-210,130,0
109146,-240086,130940,0,-310700,169451,-1,124,1
1010137,-826181,-182657,1299,-1254532,-279018,-210,130,0
-120,-3,124,1,-427,14354,0,124,1
136505,-107255,-27952,1298,-1218503,-333062,-420,130,0
379614,666274,-1046540,-652,1026625,-1613150,836,130,0
-642875,1049789,-405616,1298,1620480,-627162,1464,130,0
430,-533,103,0,-15397,2976,-1,124,1
-4551,-938636,946435,3248,-1411009,1418758,-211,130,0
-20801,-110505,133905,2599,-1268148,1525589,-211,130,0
-222115,190735,31380,0,246833,40610,0,124,1
-918,-472,1390,0,-5452,16060,0,124,1
-1052390,647424,407565,2599,995414,624647,1465,130,0
686425,-193708,-491419,1298,-446387,-1137437,-420,130,0
0,1224,-1224,0,14145,-14145,0,124,1
-126755,539520,-412766,-1,1563504,-1192319,837,130,0
11061,54952,-66014,-1,87924,-105622,0,124,1
879482,-996488,118954,1948,-1495217,177632,-2,130,0
558370,-360114,-199558,-1302,-1037100,-574794,-840,130,0
738,-1413,674,-1,-16328,7793,-1,124,1
-131305,988037,-854783,1949,1505061,-1302292,1046,130,0
64,77,-141,0,8896,-16311,0,124,1
-356864,-708527,1069290,3899,-1067264,1604560,-211,130,0
-139106,50051,91003,1948,589875,1024321,837,130,0
1026388,-821631,-203458,1299,-1236308,-307087,-629,130,0
21850,-69165,47314,-1,-110664,75703,0,124,1
918,472,-1390,0,5452,-16060,0,124,1
-990638,501818,489468,648,828045,805841,1046,130,0
-301,-362,663,0,-685,1256,0,124,1
-21850,69165,-47314,1,110664,-75703,0,124,1
260659,303561,-565522,-1302,879575,-1631583,417,130,0
156137,-236390,80252,-1,-305917,103856,-1,124,1
-566822,285360,282110,648,823018,810868,1046,130,0
-41602,137155,-93604,1949,1597229,-1096799,1256,130,0
300311,-315262,16250,1299,-1449342,71220,-840,130,0
-591523,-479068,1075140,4549,-729175,1630535,417,130,0
27059,-70105,43045,-1,-112169,68873,-1,124,1
-215809,-810581,1029638,3248,-1222274,1549888,417,130,0
-839832,-159256,1003637,4549,-244246,1520771,207,130,0
-125617,240333,-114716,0,311020,-148456,1,124,1
-453717,1067990,-612973,1300,1628021,-933830,1255,130,0
380264,690325,-1068641,1948,1039612,-1610427,835,130,0
879482,113754,-992588,648,168625,-1490818,417,130,0
0,0,0,0,0,0,0,124,1
30000,30000,30000,90000,60000,60000,180000,124,1
-676026,-392615,1074490,5849,-595112,1615034,208,130,0
881433,111154,-990638,1949,164226,-1489142,417,130,0
-73,-67,141,1,-7793,16328,1,124,1
-313312,-390665,707226,3249,-906598,1629697,-211,130,0
-429017,1053039,-622074,1948,1624670,-961271,627,130,0
5226,-738,-4487,1,-2132,-12958,0,124,1
329562,-53302,-275611,649,-237961,-1280088,209,130,0
122204,1950,-122205,1949,35191,-1431746,-211,130,0
-5547,-58274,63822,1,-93239,102115,0,124,1
-965287,289260,677325,1298,476131,1115232,627,130,0
-917835,135855,782629,649,224764,1288885,837,130,0
-103,-516,620,1,-978,1175,1,124,1
40301,-956186,921084,5199,-1442429,1385661,-211,130,0
217758,-1019239,805380,3899,-1549889,1222901,-211,130,0
533669,-1076441,546670,3898,-1633887,828255,-210,130,0
-757929,-172257,932134,1948,-286350,1536063,627,130,0
140405,839181,-978937,649,1294541,-1509670,1465,130,0
-193708,-827482,1023788,2598,-1246154,1537529,-2,130,0
508969,-991288,482318,-1,-1633469,795786,-421,130,0
831,575,-1406,0,6643,-16244,-1,124,1
-482,497,-14,1,14354,-427,0,124,1
-563,243,320,0,7032,9251,0,124,1
-194500,219631,-25130,1,284228,-32521,0,124,1
-980237,365963,616223,1949,601605,1014685,836,130,0
65652,-142356,78002,1298,-1631583,890258,-421,130,0
-54,-86,140,0,-9943,16194,1,124,1
-202158,351013,-148206,649,1627602,-690004,1045,130,0
750778,-936686,186556,648,-1544024,309600,-421,130,0
0,0,0,0,0,0,0,124,1
-943186,935385,11050,3249,1408075,13825,1256,130,0
-3673,-1888,5562,1,-5452,16060,0,124,1
42251,-509620,468017,648,-1470289,1351936,-211,130,0
-221,-1099,1320,0,-12694,15249,0,124,1
-75403,336062,-258710,1949,1558895,-1202374,626,130,0
35751,909384,-945786,-651,1386709,-1440544,1046,130,0
785879,243109,-1027039,1949,367834,-1561619,628,130,0
-20801,314611,-292511,1299,1463585,-1360107,1045,130,0
-140406,60452,81253,1299,707808,921051,837,130,0
-233773,68281,165491,-1,88364,214165,-1,124,1
-137156,40951,98803,2598,471523,1118793,837,130,0
-884,-4396,5281,1,-12694,15249,0,124,1
-5226,738,4487,-1,2132,12958,0,124,1
-211908,-479068,691625,649,-1105597,1594087,-420,130,0
669525,-1075141,407565,1949,-1618177,613336,-420,130,0
740377,318511,-1056940,1948,475921,-1590736,417,130,0
125617,114716,-240333,0,148456,-311020,-1,124,1
108554,882083,-988038,2599,1326590,-1488723,1046,130,0
45922,23603,-69526,-1,37765,-111242,-1,124,1
0,0,0,0,0,0,0,124,1
-91004,-46802,140405,2599,-542535,1605189,-211,130,0
603222,-1082941,484268,4549,-1630536,727079,-211,130,0
-565,282,282,-1,8167,8167,0,124,1
943185,-213859,-729978,-652,-354219,-1203631,-212,130,0
256109,787829,-1041340,2598,1183311,-1566647,836,130,0
-276261,700726,-421866,2599,1622365,-979704,1255,130,0
343862,-248960,-92954,1948,-1145188,-436751,-840,130,0
-1068641,704626,367263,3248,1058046,549237,1255,130,0
1033538,-261960,-770929,649,-399046,-1172000,-1,130,0
641574,-1082291,444616,3899,-1625090,665913,-421,130,0
0,0,0,0,0,0,0,124,1
-636374,1079690,-443317,-1,1625298,-667171,836,130,0
7527,1804,-9331,0,5154,-26661,0,124,1
221008,786529,-1008188,-651,1212846,-1553659,1046,130,0
592822,480367,-1071891,1298,730221,-1629907,837,130,0
783929,261309,-1041340,3898,390876,-1568323,627,130,0
969836,-59153,-908735,1948,-91121,-1366391,208,130,0
-216,560,-344,0,16194,-9943,1,124,1
-213859,1017288,-802131,1298,1549678,-1222274,836,130,0
0,-122,122,0,-14145,14145,0,124,1
-1068641,703976,367263,2598,1057837,549656,1256,130,0
643524,438766,-1079691,2599,657325,-1622995,627,130,0
-70710,35355,35355,0,56568,56568,-1,124,1
18862,198133,-216996,-1,256407,-280818,-1,124,1
927584,-956836,31851,2599,-1437193,45455,-630,130,0
0,208206,-208206,0,269443,-269443,0,124,1
709176,359463,-1067991,648,538554,-1604352,417,130,0
-330,-1025,1355,0,-11848,15661,0,124,1
0,0,0,0,0,0,0,124,1
-194500,-25130,219631,1,-32521,284228,0,124,1
-969837,60452,913284,3899,88397,1368275,417,130,0
1082940,-579822,-502469,649,-875806,-755987,208,130,0
-20801,-110505,133905,2599,-1268148,1525799,-210,130,0
-339313,-722828,1066689,4548,-1088630,1598905,-420,130,0
30000,30000,30000,90000,60000,60000,180000,124,1
-976987,79302,901583,3898,118142,1351936,627,130,0
-41562,70323,-28760,1,112517,-46016,1,124,1
30000,30000,30000,90000,60000,60000,180000,124,1
-549271,392614,157955,1298,1134085,451623,837,130,0
-911335,965286,-52652,1299,1454578,-82114,1465,130,0
-1040689,252859,791729,3899,378098,1187291,837,130,0
131954,-988688,861932,5198,-1502548,1307319,-1,130,0
1059539,-505719,-553821,-1,-780077,-852973,-630,130,0
609072,-618174,11050,1948,-1425881,21994,-630,130,0
7000,2562,-9562,0,7320,-27320,0,124,1
599322,-1082941,487518,3899,-1631374,732525,-631,130,0
89053,893133,-980887,1299,1343767,-1475945,837,130,0
-840482,-173557,1017938,3899,-263098,1527684,208,130,0
-329563,51351,278210,-2,241312,1278411,627,130,0
137,-40,-97,0,-4639,-11243,0,124,1
-443,5105,-4661,1,14742,-13461,0,124,1
-44202,950335,-904834,1299,1447875,-1378750,1046,130,0
976336,-631824,-344513,-1,-1042756,-567671,-839,130,0
-738428,-315262,1058889,5199,-477598,1591573,208,130,0
644824,-1054340,410815,1299,-1620900,631560,-629,130,0
0,-940586,943835,3249,-1413732,1415825,-2,130,0
-976987,80603,900933,4549,119189,1351308,836,130,0
-865183,1001037,-133906,1948,1506527,-205074,1256,130,0
-216,-344,560,0,-9943,16194,1,124,1
-1009488,824880,187857,3249,1253275,281950,1465,130,0
122204,-664325,544070,1949,-1533341,1254322,-211,130,0
1057589,-313312,-744278,-1,-471524,-1118794,-421,130,0
-460218,-55903,516769,648,-163389,1489350,836,130,0
848931,15600,-864533,-2,24508,-1426300,-1,130,0
131954,-988688,861282,4548,-1502758,1306690,-2,130,0
648724,-84504,-565522,-1302,-192715,-1307948,-1,130,0
54,86,-140,0,9943,-16194,-1,124,1
-49999,68301,-18301,1,109282,-29282,1,124,1
30000,30000,30000,90000,60000,60000,180000,124,1
1144,147,-1291,0,1707,-14922,-1,124,1
222115,-190735,-31380,0,-246833,-40610,0,124,1
41601,-509620,468667,648,-1469451,1352774,-211,130,0
904183,68902,-969837,3248,101175,-1461910,627,130,0
110,1165,-1276,-1,13461,-14742,0,124,1
-10401,-851532,862582,649,-1406191,1423157,-421,130,0
-141313,-97786,239099,0,-126546,309422,1,124,1
662,-286,-376,0,-541,-712,1,124,1
-667576,1060189,-390665,1948,1615453,-595950,1465,130,0
-1001688,198907,806680,3899,303106,1238611,835,130,0
1026388,-823581,-200858,1949,-1238822,-302689,-211,130,0
66952,-642875,577871,1948,-1484114,1333503,-210,130,0
-213208,-137806,352963,1949,-635541,1620690,-211,130,0
-390,-270,661,1,-511,1251,1,124,1
-1320,5423,-4103,0,15661,-11848,0,124,1
399,146,-546,-1,4227,-15777,-1,124,1
-1320,-4103,5423,0,-11848,15661,0,124,1
-171607,677975,-506369,-1,1571673,-1172210,1255,130,0
354263,-1043290,692275,3248,-1605609,1063911,-631,130,0
-981537,889883,94903,3249,1339996,139718,1255,130,0
2955,-5654,2699,0,-16328,7793,-1,124,1
9145,-1292,-7853,0,-3691,-22439,1,124,1
167056,185906,-351014,1948,865750,-1632002,836,130,0
306161,1950,-306162,1949,14244,-1421482,-210,130,0
881433,109854,-989988,1299,163179,-1488723,627,130,0
-154056,-519370,676675,3249,-1201326,1559105,-210,130,0
-356864,-708527,1069290,3899,-1068311,1604351,-420,130,0
-37609,-186838,224447,0,-241791,290462,1,124,1
233773,-165491,-68281,1,-214165,-88364,1,124,1
541,860,-1402,-1,9943,-16194,-1,124,1
357513,708526,-1066040,-1,1066006,-1604771,208,130,0
-145606,919134,-774180,-652,1519724,-1278831,837,130,0
30000,30000,30000,90000,60000,60000,180000,124,1
354263,-159256,-193708,1299,-729175,-901152,-421,130,0
122204,1950,-122205,1949,37495,-1432794,208,130,0
343862,-248960,-92954,1948,-1147492,-433609,-840,130,0
219058,341912,-561622,-652,988082,-1620062,418,130,0
216,-560,344,0,-16194,9943,-1,124,1
133905,863882,-997788,-1,1303339,-1504014,1466,130,0
-230759,1032888,-800831,1298,1556801,-1207192,1046,130,0
527819,-1084241,560971,4549,-1633469,843546,-2,130,0
883383,-58503,-826831,-1951,-97405,-1363039,-1,130,0
30000,30000,30000,90000,60000,60000,180000,124,1
-615574,1080990,-462818,2598,1628440,-699849,1255,130,0
726727,323062,-1048490,1299,489537,-1593878,208,130,0
0,0,0,0,0,0,0,124,1
-705277,393914,312661,1298,910368,719957,1255,130,0
813180,-1032889,222308,2599,-1551984,333061,-421,130,0
-333463,267160,68252,1949,1235260,308343,836,130,0
367,188,-556,-1,5452,-16060,0,124,1
-52,599,-547,0,1136,-1037,1,124,1
30000,30000,30000,90000,60000,60000,180000,124,1
155,482,-637,0,912,-1206,-1,124,1
-427066,533019,-106604,-651,1543813,-308554,1255,130,0
92003,-238359,146356,0,-308465,189402,0,124,1
-828782,-193708,1025738,3248,-293262,1538367,418,130,0
-139756,78652,62402,1298,926707,701942,1046,130,0
134,-105,-29,0,-12138,-3396,0,124,1
30000,30000,30000,90000,60000,60000,180000,124,1
1084890,-487519,-596723,648,-733783,-896753,-1,130,0
-5040,296,4744,0,854,13698,-1,124,1
332,-562,230,0,-16244,6643,-1,124,1
-44202,-588923,635073,1948,-1359478,1464214,-210,130,0
55252,888583,-943186,649,1370789,-1454579,1255,130,0
-605823,616873,-9101,1949,1427765,-25766,1255,130,0
-137156,40951,98803,2598,466286,1122354,418,130,0
-221,1320,-1099,0,15249,-12694,0,124,1
35751,286660,-319812,2599,1329104,-1486628,837,130,0
-992588,503768,487518,-1302,830978,802908,1046,130,0
12350,115054,-126105,1299,1342929,-1476573,837,130,0
135855,406265,-543421,-1301,1178493,-1568532,627,130,0
438766,640273,-1079041,-2,963155,-1623623,837,130,0
776,8158,-8935,-1,23309,-25528,0,124,1
0,0,0,0,0,0,0,124,1
-646,188,457,-1,357,866,0,124,1
-1062140,507018,557070,1948,780076,853391,1465,130,0
135205,-989988,859982,5199,-1504014,1304805,418,130,0
55902,-141706,87753,1949,-1619434,997299,-630,130,0
958135,-874933,-81254,1948,-1347329,-126522,-421,130,0
399,-546,146,-1,-15777,4227,-1,124,1
-1085541,473867,613622,1948,711578,917699,836,130,0
541,860,-1402,-1,9943,-16194,-1,124,1
3999,-5464,1464,-1,-15777,4227,-1,124,1
947735,-934736,-9101,3898,-1407029,-15501,-211,130,0
-421216,-655875,1080990,3899,-987245,1620480,-1,130,0
5547,-63822,58274,-1,-102115,93239,0,124,1
-822281,991287,-167057,1949,1527265,-260375,1256,130,0
-3325,5625,-2300,0,16244,-6643,1,124,1
-1414,707,707,0,8167,8167,0,124,1
61752,-968537,910684,3899,-1457721,1367647,-1,130,0
-278861,-767679,1049139,2599,-1157756,1576910,-420,130,0
916534,-965937,51351,1948,-1451437,76038,-421,130,0
-382865,-664325,1049789,2599,-1024322,1613987,-1,130,0
1077090,-653275,-421866,1949,-984941,-636169,-420,130,0
625973,-29902,-596723,-652,-66822,-1379797,-211,130,0
330862,-707877,379614,2599,-1632631,871406,-630,130,0
75402,66302,-139106,2598,778819,-1632421,627,130,0
662,-286,-376,0,-541,-712,1,124,1
126,-118,-7,1,-13698,-854,1,124,1
-42252,-95554,140405,2599,-1090725,1598276,-421,130,0
-106604,-25351,135855,3900,-295357,1538786,418,130,0
-458918,-597373,1059539,3248,-921261,1628859,-1,130,0
27059,43045,-70105,-1,68873,-112169,-1,124,1
6429,3304,-9733,0,9441,-27810,0,124,1
-34452,-287961,324362,1949,-1328686,1487256,-1,130,0
9625,-6814,-2811,0,-19469,-8033,0,124,1
840481,174206,-1014038,649,260165,-1526009,627,130,0
-434217,-642875,1081640,4548,-968602,1623203,-211,130,0
729327,302261,-1030289,1299,464400,-1588013,417,130,0
221,-1320,1099,0,-15249,12694,0,124,1
-16507,-51291,67798,0,-82066,108478,1,124,1
-380265,-687726,1071890,3899,-1038357,1611473,-2,130,0
21850,47314,-69165,-1,75703,-110664,0,124,1
101403,554470,-655225,648,1284277,-1516164,627,130,0
52,-599,547,0,-1136,1037,-1,124,1
-709177,-355564,1071240,6499,-537507,1604560,208,130,0
757928,170956,-929535,-651,281112,-1533341,836,130,0
558,-202,-355,1,-5853,-10279,1,124,1
-1054340,705276,353613,4549,1070614,533317,836,130,0
93603,46151,-137156,2598,544000,-1605399,627,130,0
-8451,615573,-606473,649,1425880,-1403258,1046,130,0
-112455,128054,-13651,1948,1495216,-176795,1047,130,0
-8008,-1034,9043,1,-2956,25838,0,124,1
182813,43812,-226626,-1,56698,-293281,-1,124,1
30000,30000,30000,90000,60000,60000,180000,124,1
332,-562,230,0,-16244,6643,-1,124,1
771578,-1018589,248959,1948,-1567066,383125,-421,130,0
609072,-618174,10400,1298,-1425462,21575,-630,130,0
707876,-347114,-359464,1298,-800396,-832654,-1,130,0
796929,-1038089,244409,3249,-1562457,366786,-630,130,0
529119,-1084891,559670,3898,-1633678,841451,-2,130,0
1059539,-506369,-553171,-1,-781543,-851297,-420,130,0
275610,-1023789,752078,3899,-1577539,1156289,-420,130,0
-369214,978286,-610373,-1301,1617757,-1007145,1046,130,0
-800180,-231409,1036138,4549,-351077,1557219,626,130,0
100,36,-136,0,4227,-15777,0,124,1
1066689,-419916,-646775,-2,-637007,-983894,-2,130,0
705276,-395215,-310062,-1,-911416,-718282,-420,130,0
-1077091,433566,646774,3249,650412,972791,1255,130,0
1004287,-867133,-135856,1298,-1301035,-205493,-420,130,0
-504,474,29,-1,13698,854,-1,124,1
325662,-286661,-38352,649,-1315280,-181823,-421,130,0
545370,-664975,120254,649,-1532503,275456,-630,130,0
-796930,907433,-111155,-652,1498567,-184755,1465,130,0
209957,-1025089,819680,4548,-1545071,1232537,-1,130,0
-125455,7150,120254,1949,88188,1368066,209,130,0
-2568,-3080,5649,1,-8896,16311,0,124,1
0,0,0,0,0,0,0,124,1
738,674,-1413,-1,7793,-16328,-1,124,1
-53768,66654,-12885,1,106647,-20617,0,124,1
132,410,-542,0,11848,-15661,0,124,1
504,-474,-29,1,-13698,-854,1,124,1
4550,486218,-492719,-1951,1409960,-1419178,836,130,0
-391315,1071240,-678626,1299,1614824,-1022437,1255,130,0
-349714,1040688,-689676,1298,1605608,-1064750,1046,130,0
-1087491,546670,544070,3249,820085,813591,1045,130,0
537,-117,-420,0,-3396,-12138,0,124,1
-169657,550570,-380915,-2,1595762,-1102036,1046,130,0
232058,-1034839,805380,2599,-1555754,1209704,-211,130,0
-914585,963986,-47452,1949,1451226,-74992,1255,130,0
-3673,-1888,5562,1,-5452,16060,0,124,1
-254160,563571,-308762,649,1631373,-894868,1046,130,0
-987387,566821,420565,-1,935505,692516,1256,130,0
-794330,908084,-113755,-1,1500243,-189154,1256,130,0
30000,30000,30000,90000,60000,60000,180000,124,1
-1057590,752078,306811,1299,1129267,457697,836,130,0
-289261,-30552,321762,1949,-140347,1479296,418,130,0
109146,-240086,130940,0,-310700,169451,-1,124,1
1205,-1242,37,0,-14354,427,0,124,1
-1260,1186,74,0,13698,854,-1,124,1
0,489,-489,0,14145,-14145,0,124,1
-676026,518069,159255,1298,1198183,362597,836,130,0
339312,-79953,-257410,1949,-367206,-1194623,-211,130,0
973736,-91004,-880133,2599,-139928,-1339159,-1,130,0
93603,-141056,48751,1298,-1607284,550494,-210,130,0
455667,624023,-1079041,649,938437,-1626556,627,130,0
-430,533,-103,0,15397,-2976,1,124,1
957485,-925635,-30552,1298,-1391318,-46294,-839,130,0
1083590,-488169,-595423,-2,-735250,-895496,-211,130,0
-73,141,-67,1,16328,-7793,1,124,1
776,-8935,8158,-1,-25528,23309,0,124,1
592,-34,-557,1,-65,-1055,1,124,1
53768,-66654,12885,-1,-106647,20617,0,124,1
205407,-352964,151455,3898,-1627813,691259,-421,130,0
-253510,563571,-310062,-1,1630954,-898848,627,130,0
-598023,1080340,-482969,-652,1630744,-728547,1464,130,0
-82554,-57853,141705,1298,-658792,1623413,-1,130,0
-134556,29901,107254,2599,341649,1212637,836,130,0
-2310,9491,-7180,1,27119,-20516,1,124,1
173556,-553821,380914,649,-1596392,1098893,-421,130,0
155355,518719,-673426,648,1201744,-1558896,1046,130,0
-469,-172,642,1,-325,1215,1,124,1
-992588,502468,489468,-652,828464,805631,1255,130,0
65002,-143006,78652,648,-1631374,894238,-840,130,0
-452417,1067339,-614924,-2,1627812,-936762,1256,130,0
-683176,1070590,-386115,1299,1613358,-582335,1045,130,0
135205,863882,-997788,1299,1302710,-1504643,1255,130,0
74752,-143006,69552,1298,-1633469,786150,-421,130,0
120,-124,3,-1,-14354,427,0,124,1
0,0,0,0,0,0,0,124,1
-99,136,-36,1,15777,-4227,1,124,1
-87754,-253510,342562,1298,-1165925,1573768,-210,130,0
-504,474,29,-1,13698,854,-1,124,1
-568772,-516770,1088790,3248,-777982,1632630,-420,130,0
-328263,705276,-375715,1298,1632630,-870569,1046,130,0
930834,-27952,-902884,-2,-43780,-1391737,208,130,0
92953,436166,-528470,649,1263958,-1528313,837,130,0
-592,34,557,-1,65,1055,-1,124,1
-569422,-515470,1088790,3898,-776516,1632630,208,130,0
-1034189,229458,809930,5199,341649,1212427,626,130,0
522,-73,-448,1,-2132,-12958,0,124,1
0,0,0,0,0,0,0,124,1
-130655,-865183,999737,3899,-1304387,1504013,417,130,0
1082940,-508320,-574622,-2,-767927,-864494,-1,130,0
-102054,342562,-239209,1299,1592201,-1112929,1045,130,0
-88404,-893134,984786,3248,-1342930,1477201,208,130,0
89703,892483,-981537,649,1342719,-1476573,836,130,0
12350,-128055,118304,2599,-1472593,1348794,-211,130,0
-980887,365313,616873,1299,600139,1015942,1046,130,0
1025088,-276261,-747529,1298,-426696,-1151891,-211,130,0
226858,-349714,125454,2598,-1611264,570813,-629,130,0
-2568,5649,-3080,1,16311,-8896,0,124,1
30000,30000,30000,90000,60000,60000,180000,124,1
429666,-536271,107254,649,-1543605,307924,-421,130,0
-877533,835281,41601,-651,1380425,66821,1046,130,0
4823,148,-4971,0,427,-14354,0,124,1
-456968,-599323,1060189,3898,-925241,1628440,-1,130,0
208007,-1025089,820980,3898,-1543605,1235469,417,130,0
988687,-504419,-485569,-1301,-833073,-799977,-1,130,0
330212,-54603,-274961,648,-245502,-1275480,-1,130,0
1077090,-651975,-424466,649,-982846,-638473,-210,130,0
-124805,7150,120254,2599,91539,1366599,627,130,0
12350,-128705,118304,1949,-1474479,1346280,-212,130,0
-1306,184,1121,-1,2132,12958,0,124,1
-1014689,839831,177456,2598,1264377,264354,1465,130,0
1144,-1291,147,0,-14922,1707,-1,124,1
-1084891,510269,576571,1949,767717,865331,1465,130,0
-333463,1061489,-726728,1298,1597648,-1094914,837,130,0
788479,239858,-1025739,2598,363435,-1560153,837,130,0
343862,-249610,-92954,1298,-1147701,-433190,-630,130,0
-113755,-14951,130654,1948,-166322,1490398,627,130,0
664,-332,-332,0,-629,-629,0,124,1
416665,-1079041,664974,2598,-1619434,997089,-631,130,0
603872,-1074491,471917,1298,-1629907,716606,-210,130,0
-504,29,474,-1,854,13698,-1,124,1
-272361,-58503,333462,2598,-267288,1528941,417,130,0
-2310,9491,-7180,1,27119,-20516,1,124,1
512869,-991288,478417,-2,-1633469,789921,-211,130,0
-213208,-811231,1029638,5199,-1224578,1548631,-2,130,0
-41562,70323,-28760,1,112517,-46016,1,124,1
5587,-3559,-2027,1,-10279,-5853,1,124,1
-136506,40301,99453,3248,465448,1122983,418,130,0
-662,376,286,0,712,541,-1,124,1
-729328,1045889,-314612,1949,1592830,-480740,1256,130,0
-361414,-344513,708526,2599,-799348,1633049,-1,130,0
131304,-20151,-110505,648,-217014,-1293285,-1,130,0
91003,249609,-339963,649,1162573,-1574816,627,130,0
110504,880132,-989338,1298,1324705,-1489980,1255,130,0
194500,-219631,25130,-1,-284228,32521,0,124,1
-938636,-1951,944485,3898,-5447,1417292,836,130,0
30000,30000,30000,90000,60000,60000,180000,124,1
-131955,988037,-855433,649,1505480,-1301873,1465,130,0
-564222,325012,239858,648,937390,690631,1256,130,0
1320,4103,-5423,0,11848,-15661,0,124,1
5587,-3559,-2027,1,-10279,-5853,1,124,1
142355,-62403,-77353,2599,-703410,-924822,-211,130,0
0,0,0,0,0,0,0,124,1
-1053040,646774,408865,2599,993947,626113,1255,130,0
32101,-70613,38511,-1,-112982,61618,-1,124,1
-1046540,276260,774179,3899,413080,1162363,1046,130,0
0,0,0,0,0,0,0,124,1
-215159,-810581,1030288,4548,-1222693,1549678,417,130,0
87103,-527170,442016,1949,-1522239,1274850,-212,130,0
-62403,139755,-76053,1299,1631582,-894239,1255,130,0
1083590,-581122,-501169,1299,-877272,-754731,-211,130,0
9750,850231,-861283,-1302,1407028,-1422320,837,130,0
-61753,639623,-577222,648,1481809,-1336227,1464,130,0
0,0,0,0,0,0,0,124,1
-892484,-87104,982836,3248,-131968,1475944,627,130,0
-45922,69526,-23603,1,111242,-37765,1,124,1
219058,341912,-561622,-652,988920,-1619853,417,130,0
707226,-346463,-360114,649,-799558,-833702,-421,130,0
-1052390,650024,404965,2599,999813,619410,1255,130,0
-1075141,687725,390014,2598,1031652,581496,1255,130,0
949035,-20151,-927585,1299,-33516,-1397393,208,130,0
44,466,-510,0,13461,-14742,0,124,1
-878183,833981,43551,-651,1378749,70173,1046,130,0
697476,-245710,-451117,649,-565786,-1044012,-420,130,0
240416,-120208,-120208,0,-155563,-155563,0,124,1
739077,-1049140,313961,3898,-1591365,474874,-2,130,0
3788,6026,-9814,0,17218,-28042,-1,124,1
16507,-67798,51291,0,-108478,82066,-1,124,1
-522,73,448,-1,2132,12958,0,124,1
284060,-328263,45501,1298,-1505271,202141,-629,130,0
-643525,1049789,-405616,648,1620271,-627371,1256,130,0
56552,888583,-943836,1299,1370370,-1455207,1256,130,0
-214212,201630,12582,0,260933,16283,0,124,1
429016,-536921,108554,649,-1544652,311276,-420,130,0
217108,811880,-1027689,1299,1222273,-1549260,1047,130,0
1086840,-545371,-541471,-2,-820086,-813173,-1,130,0
-1037439,712426,327612,2599,1096589,500639,1255,130,0
738,-1413,674,-1,-16328,7793,-1,124,1
-749479,1053689,-302912,1298,1587384,-458327,837,130,0
140,-80,-60,0,-9251,-7032,0,124,1
-745578,936035,-189158,1299,1545908,-314419,1046,130,0
-789780,1023138,-231409,1949,1559105,-355685,1465,130,0
-231409,1032238,-800180,649,1557010,-1206773,1464,130,0
131954,-19501,-111155,1298,-213453,-1295170,418,130,0
-27059,-43045,70105,1,-68873,112169,1,124,1
638973,-976987,338012,-2,-1608960,557825,-630,130,0
-276261,700726,-421866,2599,1622365,-979704,1046,130,0
30000,30000,30000,90000,60000,60000,180000,124,1
-2164,5608,-3443,1,16194,-9943,1,124,1
1004937,-865183,-139106,648,-1298103,-209892,-211,130,0
0,0,0,0,0,0,0,124,1
-8820,518,8302,0,1480,23721,0,124,1
1051739,-647425,-403016,1298,-997300,-621925,-630,130,0
-43,-94,138,1,-10929,15977,1,124,1
91,47,-139,-1,5452,-16060,0,124,1
969186,-114405,-854132,649,-177424,-1317165,-211,130,0
27059,-70105,43045,-1,-112169,68873,-1,124,1
30000,30000,30000,90000,60000,60000,180000,124,1
30000,30000,30000,90000,60000,60000,180000,124,1
757278,170306,-928885,-1301,279855,-1532922,836,130,0
-575922,1057589,-481669,-2,1631792,-743419,1465,130,0
121554,2600,-122205,1949,40009,-1433841,-1,130,0
757928,170306,-928885,-651,280483,-1533341,626,130,0
-1144,1291,-147,0,14922,-1707,1,124,1
-41602,136505,-93604,1299,1597648,-1094914,837,130,0
69840,-25340,-44499,1,-40544,-71199,1,124,1
1058239,-313312,-743628,1299,-472361,-1118166,-420,130,0
2568,-5649,3080,-1,-16311,8896,0,124,1
988687,-503769,-486869,-1951,-832026,-801024,-211,130,0
347,-664,317,0,-1258,600,-1,124,1
-133906,104653,30551,1298,1216407,336622,1255,130,0
-239675,103501,136173,-1,133943,176224,0,124,1
83203,-978937,899633,3899,-1471965,1349632,417,130,0
-799530,-232059,1036138,4549,-351915,1557429,627,130,0
977636,-363364,-616874,-2602,-599930,-1015734,-421,130,0
593472,478417,-1071891,-2,727289,-1629698,837,130,0
672125,-1065390,397164,3899,-1616292,600767,-211,130,0
0,0,0,0,0,0,0,124,1
-5172,-4723,9896,1,-13496,28274,0,124,1
3059,-9683,6624,0,-27666,18925,-1,124,1
155,-637,482,0,-1206,912,-1,124,1
-957486,874282,85153,1949,1346909,127987,1465,130,0
-664325,1073190,-406266,2599,1618385,-614593,1255,130,0
30000,30000,30000,90000,60000,60000,180000,124,1
430,103,-533,0,2976,-15397,-1,124,1
-650025,82553,570071,2599,189991,1309832,417,130,0
-565,282,282,-1,8167,8167,0,124,1
539520,-122855,-417966,-1301,-351496,-1205516,-421,130,0
-375715,704626,-327613,1298,1632839,-761224,1046,130,0
355563,-1043290,690975,3248,-1606237,1061817,-629,130,0
443316,-989338,546670,648,-1630536,901779,-211,130,0
1010787,-164457,-846332,-2,-248226,-1273804,208,130,0
-764429,1050439,-284711,1299,1580052,-430048,1046,130,0
-876883,994537,-116355,1299,1495634,-177424,1464,130,0
373113,-981537,609072,648,-1617968,1004840,-421,130,0
492068,191107,-685126,-1951,444710,-1583195,208,130,0
121554,-125455,6500,2599,-1438868,49645,-420,130,0
-531070,-137806,671475,2599,-320075,1547165,417,130,0
-256,-308,564,0,-8896,16311,0,124,1
41562,28760,-70323,-1,46016,-112517,-1,124,1
53768,12885,-66654,-1,20617,-106647,0,124,1
-367,-188,556,1,-5452,16060,0,124,1
276910,-1024439,750778,3249,-1578377,1154403,-421,130,0
-68756,20082,48674,0,32132,77878,-1,124,1
-20151,315911,-292511,3249,1462538,-1361363,628,130,0
-484269,-11701,497268,1298,-34773,1431745,627,130,0
710476,359463,-1067340,2599,537087,-1604142,208,130,0
27059,-70105,43045,-1,-112169,68873,-1,124,1
78002,-338663,261959,1298,-1559106,1201954,-630,130,0
354263,-159256,-193708,1299,-729384,-900943,-211,130,0
597372,26000,-624674,-1302,62422,-1444524,-2,130,0
565,-282,-282,1,-8167,-8167,0,124,1
-172257,678625,-505069,1299,1572930,-1169277,1255,130,0
70492,-30441,-40050,1,-48706,-64081,1,124,1
-72153,139755,-65653,1949,1633468,-779867,1466,130,0
-469,642,-172,1,1215,-325,1,124,1
-558,355,202,-1,10279,5853,-1,124,1
-3325,5625,-2300,0,16244,-6643,1,124,1
30000,30000,30000,90000,60000,60000,180000,124,1
-214212,201630,12582,0,260933,16283,0,124,1
-9625,2811,6814,0,8033,19469,0,124,1
-81254,978936,-897684,-2,1472383,-1348795,1046,130,0
-171607,677975,-506369,-1,1571464,-1172419,1046,130,0
6429,3304,-9733,0,9441,-27810,0,124,1
-591523,-477118,1074490,5849,-727709,1630535,417,130,0
306161,1950,-305512,2599,13196,-1420854,207,130,0
-3059,9683,-6624,0,27666,-18925,1,124,1
458917,598672,-1056940,649,921679,-1628441,417,130,0
-313962,-390665,707226,2599,-905341,1629906,-211,130,0
-887284,62402,826830,1948,101594,1361362,836,130,0
0,-208206,208206,0,-269443,269443,0,124,1
1005587,-146906,-858683,-2,-221832,-1290143,208,130,0
-124805,7150,120254,2599,91330,1366599,627,130,0
-2310,9491,-7180,1,27119,-20516,1,124,1
-44852,-588273,635073,1948,-1358012,1465051,-212,130,0
-3673,5562,-1888,1,16060,-5452,0,124,1
-141056,69552,72152,648,817990,815686,1045,130,0
-1025089,824230,203457,2598,1240078,301431,1256,130,0
-981537,364663,616873,-1,599301,1016570,627,130,0
125617,114716,-240333,0,148456,-311020,-1,124,1
36401,-954886,922384,3899,-1440125,1388175,-1,130,0
-550,389,160,-1,11243,4639,0,124,1
-1034839,809280,225558,-1,1217036,335994,1256,130,0
-327613,560971,-233359,-1,1626136,-676388,836,130,0
0,0,0,0,0,0,0,124,1
30000,30000,30000,90000,60000,60000,180000,124,1
530419,-1076441,549270,3248,-1633887,832863,-210,130,0
0,-61237,61237,0,-97979,97979,0,124,1
-563,243,320,0,7032,9251,0,124,1
366613,689675,-1056940,-652,1049667,-1608122,837,130,0
345812,-108555,-236609,648,-493518,-1101827,-420,130,0
-1059540,313961,747528,1949,469428,1120469,1046,130,0
-56124,230515,-174391,0,298314,-225683,0,124,1
-911335,966586,-52652,2599,1454787,-82533,1464,130,0
1082940,-615574,-466718,648,-926289,-702153,-211,130,0
234658,111154,-344513,1299,518235,-1600372,-2,130,0
386764,594772,-982187,-651,981589,-1621319,209,130,0
60290,-62141,1850,-1,-99426,2961,0,124,1
0,0,0,0,0,0,0,124,1
-111155,967236,-856083,-2,1492911,-1320935,1255,130,0
-373765,704626,-328913,1948,1632839,-764366,1256,130,0
167056,185906,-351014,1948,867426,-1632002,837,130,0
-738,1413,-674,1,16328,-7793,1,124,1
831,-1406,575,0,-16244,6643,-1,124,1
-822281,990637,-165107,3249,1526636,-258071,1464,130,0
884033,-60453,-826181,-2601,-100547,-1361573,-211,130,0
444616,-989338,545370,648,-1630745,900313,-420,130,0
-846332,1010137,-161857,1948,1521819,-245712,1465,130,0
194357,-999088,808630,3899,-1539206,1243639,-2,130,0
-409516,-293812,705926,2598,-679949,1626136,208,130,0
-127405,986086,-858033,648,1502757,-1306482,1255,130,0
-576572,641574,-63053,1949,1484323,-150821,1255,130,0
-988038,568121,419915,-2,937390,690631,1256,130,0
1082940,-488169,-595423,-652,-735878,-894868,-211,130,0
563,-320,-243,0,-9251,-7032,0,124,1
-109146,240086,-130940,0,310700,-169451,1,124,1
559020,-208008,-352314,-1302,-597207,-1018038,-421,130,0
-48102,-911985,964636,4549,-1375817,1450807,-2,130,0
0,-1224,1224,0,-14145,14145,0,124,1
796279,-1026389,232058,1948,-1558058,352961,-1,130,0
-69840,25340,44499,-1,40544,71199,-1,124,1
-1069941,702676,368563,1298,1056161,551751,1256,130,0
30000,30000,30000,90000,60000,60000,180000,124,1
-558,202,355,-1,5853,10279,-1,124,1
566821,-1087491,524569,3899,-1633469,786569,-212,130,0
55252,-141056,88403,2599,-1618805,999394,-420,130,0
-982837,887283,98803,3249,1336854,145164,1465,130,0
749478,-937336,187857,-1,-1544652,311485,-211,130,0
-352964,157305,196957,1298,728546,901989,837,130,0
1016638,-837232,-177457,1949,-1261864,-267707,-421,130,0
520019,555120,-1073841,1298,843965,-1632421,1256,130,0
55252,-141706,87753,1299,-1618805,999184,-630,130,0
-67249,52548,14701,0,84077,23522,0,124,1
-65328,9229,56098,-1,14767,89757,-1,124,1
252859,-1042640,791729,1948,-1565390,1187081,-421,130,0
508319,-1061490,555770,2599,-1633259,854439,-420,130,0
545370,-664325,120254,1299,-1532293,275247,-420,130,0
-588273,-494019,1086190,3898,-745514,1631163,-211,130,0
0,0,0,0,0,0,0,124,1
-644825,1050439,-403666,1948,1619852,-624229,1046,130,0
-299012,-266510,566171,649,-768556,1632420,208,130,0
-211908,-138456,352963,2599,-640568,1621318,-2,130,0
-1414,707,707,0,8167,8167,0,124,1
30000,30000,30000,90000,60000,60000,180000,124,1
603222,-1073841,473217,2598,-1629907,718281,208,130,0
-1067340,421215,648724,2599,638682,983055,1256,130,0
-193058,-828132,1023788,2598,-1246363,1537529,-2,130,0
-856083,-146256,1006887,4548,-223717,1513440,1047,130,0
-4576,-591,5167,0,-1707,14922,1,124,1
-459568,-528470,988687,649,-873711,1632211,208,130,0
-1066690,638323,432266,3899,970486,653554,1464,130,0
-460868,-54603,516119,648,-158781,1487465,627,130,0
30000,30000,30000,90000,60000,60000,180000,124,1
30000,30000,30000,90000,60000,60000,180000,124,1
1320,4103,-5423,0,11848,-15661,0,124,1
696826,-959436,263259,649,-1581100,435074,-211,130,0
-349714,132604,220358,3248,613754,1004212,836,130,0
192407,161206,-351014,2599,753892,-1631374,627,130,0
0,0,0,0,0,0,0,124,1
-585022,-496619,1086840,5199,-748865,1631373,209,130,0
67249,-52548,-14701,0,-84077,-23522,0,124,1
-310712,1054989,-743628,649,1589897,-1120679,837,130,0
-562922,1084890,-522620,-652,1633468,-786780,1046,130,0
44851,92953,-136506,1298,1091352,-1597858,208,130,0
918,472,-1390,0,5452,-16060,0,124,1
370513,183306,-555121,-1302,531851,-1602885,418,130,0
-1062140,507669,556420,1949,780704,852763,1255,130,0
-295,565,-269,1,16328,-7793,1,124,1
-85804,525219,-441367,-1952,1522028,-1274642,836,130,0
-497269,-586322,1087490,3899,-882718,1631582,418,130,0
30000,30000,30000,90000,60000,60000,180000,124,1
1034838,-229459,-804081,1298,-347097,-1208448,-1,130,0
586971,394564,-982837,-1302,650831,-1622366,627,130,0
1006237,-145606,-859333,1298,-220366,-1290981,207,130,0
541,-1402,860,-1,-16194,9943,-1,124,1
-469968,1080990,-610373,649,1629278,-920005,836,130,0
-328913,51351,278860,1298,242150,1277992,627,130,0
5656,-2828,-2828,0,-8167,-8167,0,124,1
301,-663,362,0,-1256,685,0,124,1
60452,-967887,911334,3899,-1456883,1368275,-211,130,0
3900,486218,-492069,-1951,1409751,-1419597,1046,130,0
139105,-41602,-95554,1949,-464611,-1123821,-420,130,0
194500,25130,-219631,-1,32521,-284228,0,124,1
55902,-141706,87753,1949,-1619643,996461,-1049,130,0
482,14,-497,-1,427,-14354,0,124,1
30000,30000,30000,90000,60000,60000,180000,124,1
44851,92953,-135856,1948,1089676,-1598277,836,130,0
0,575,-575,0,1090,-1090,0,124,1
-642225,-436167,1082940,4548,-657954,1623622,208,130,0
700076,-438117,-261310,649,-1010916,-605796,-421,130,0
-730628,1045889,-313962,1299,1592620,-479693,1255,130,0
209957,478417,-687726,648,1109367,-1592831,836,130,0
-1000,1366,-366,0,15777,-4227,0,124,1
235308,110504,-344513,1299,515931,-1599743,-1,130,0
985436,-566172,-420566,-1302,-934877,-692936,-630,130,0
-1036139,232708,806680,3249,347724,1208657,1255,130,0
-559671,206057,354263,649,595111,1019922,627,130,0
130654,-988688,861932,3898,-1502339,1307319,-1,130,0
-731278,1058239,-325663,1298,1595343,-492052,1045,130,0
1409,-608,-801,0,-7032,-9251,0,124,1
-400,-146,546,0,-4227,15777,0,124,1
-3325,-2300,5625,0,-6643,16244,1,124,1
926934,27951,-954236,649,40428,-1434051,208,130,0
706576,-394565,-311362,649,-910159,-719749,-420,130,0
-559671,205407,354263,-1,592598,1022017,627,130,0
332162,-707877,378314,2599,-1632631,870149,-630,130,0
-570722,-514820,1088140,2598,-775468,1632630,209,130,0
-950336,24700,930184,4548,33725,1397811,628,130,0
976336,-631174,-344513,649,-1041918,-568719,-840,130,0
436166,640924,-1078391,-1301,964831,-1623414,418,130,0
-33,-102,135,0,-11848,15661,0,124,1
0,489,-489,0,14145,-14145,0,124,1
-254810,-85804,341262,648,-392762,1569159,-2,130,0
-301612,-728028,1032888,3248,-1124031,1588431,-211,130,0
707226,-347764,-358814,648,-801234,-832026,-211,130,0
849581,-999088,152755,3248,-1515954,230210,-211,130,0
-316562,-653275,970486,649,-1080042,1601209,-630,130,0
632,-493,-138,1,-935,-261,1,124,1
638973,442016,-1079691,1298,663399,-1624042,627,130,0
-1052390,344512,713726,5848,522215,1079622,837,130,0
-894434,960735,-64353,1948,1462957,-100966,1465,130,0
16507,-67798,51291,0,-108478,82066,-1,124,1
128054,-542121,414065,-2,-1562457,1194413,-420,130,0
-1075791,655224,424465,3898,985359,636168,1465,130,0
432916,97503,-531070,-651,284463,-1535016,-2,130,0
482318,-499219,17550,649,-1439916,51949,-1,130,0
5639,-3204,-2435,0,-9251,-7032,0,124,1
-36402,-910035,951635,5198,-1385034,1443057,-211,130,0
273660,-1023789,752728,2599,-1577120,1157336,-420,130,0
558370,-360114,-198908,-652,-1038776,-572489,-421,130,0
697476,-245710,-451117,649,-566205,-1043593,-420,130,0
30000,30000,30000,90000,60000,60000,180000,124,1
537,69,-607,-1,131,-1149,0,124,1
-493369,-189808,687075,3898,-440312,1582147,208,130,0
960085,-687076,-274311,-1302,-1134086,-451414,-630,130,0
287960,750778,-1038739,-1,1142882,-1581729,836,130,0
1053689,-339963,-712427,1299,-518026,-1082346,-1,130,0
-840482,872982,-33152,-652,1442638,-56349,1255,130,0
348413,-228809,-118955,649,-1051134,-557826,-1048,130,0
-651975,-319162,971786,649,-527453,1602466,-1,130,0
-170307,550570,-380915,-652,1596181,-1100570,836,130,0
492718,191107,-685126,-1301,445757,-1583405,417,130,0
-443,-4661,5105,1,-13461,14742,0,124,1
-141056,-839182,982836,2598,-1293285,1510926,208,130,0
390,-661,270,-1,-1251,511,-1,124,1
358163,709176,-1066040,1299,1066215,-1604561,627,130,0
63052,269760,-330863,1949,1250132,-1535435,627,130,0
295111,-566172,273010,1949,-1633678,786779,-630,130,0
1396,-889,-506,1,-10279,-5853,1,124,1
-369864,-184607,556420,1949,-536041,1604351,418,130,0
30000,30000,30000,90000,60000,60000,180000,124,1
-237456,86157,151298,-1,111497,195798,-1,124,1
722827,340612,-1062790,649,510484,-1598487,417,130,0
931484,-28602,-902234,648,-45875,-1390690,-2,130,0
642,770,-1412,0,8896,-16311,0,124,1
-328913,50701,278860,648,240055,1279249,836,130,0
637673,-976987,339312,-2,-1609170,559711,-630,130,0
-352964,157305,196957,1298,727917,902408,627,130,0
0,0,0,0,0,0,0,124,1
-937336,-2601,945135,5198,-7123,1418130,627,130,0
522619,-452417,-68903,1299,-1304596,-199209,-420,130,0
-703977,297061,409515,2599,684347,942627,1047,130,0
-103,-516,620,1,-978,1175,1,124,1
0,0,0,0,0,0,0,124,1
-770279,-276911,1052389,5199,-418108,1576491,417,130,0
-1067340,421865,648724,3249,639101,982636,1256,130,0
1409,-608,-801,0,-7032,-9251,0,124,1
0,0,0,0,0,0,0,124,1
-140406,59802,81253,649,708017,920841,626,130,0
-542771,662374,-117655,1948,1532921,-276714,1256,130,0
-976987,631173,346462,648,1041917,569137,837,130,0
-642875,1049789,-406266,648,1620480,-627790,1465,130,0
169999,-232224,62224,-1,-300525,80525,-1,124,1
139,-88,-50,1,-10279,-5853,1,124,1
74752,65652,-139106,1298,775677,-1632421,418,130,0
-288611,-31202,322412,2599,-142232,1480134,209,130,0
3059,-9683,6624,0,-27666,18925,-1,124,1
-839832,-156656,1002337,5849,-240685,1519724,836,130,0
-687076,193707,494018,649,446176,1137646,836,130,0
-351664,204107,149505,1948,946607,680157,1046,130,0
-539521,121554,417965,-2,352542,1205305,1045,130,0
-11061,-54952,66014,1,-87924,105622,0,124,1
-454368,516769,-61753,648,1496891,-180985,1045,130,0
-981537,890533,94253,3249,1340834,138670,1674,130,0
-91654,-47452,140405,1299,-538974,1604560,207,130,0
885983,-61103,-826181,-1301,-101176,-1361154,-211,130,0
-9751,-852182,861932,-1,-1407029,1422529,-420,130,0
260659,303561,-565522,-1302,878737,-1631374,626,130,0
235308,111804,-345163,1949,520958,-1600791,208,130,0
102703,35101,-134556,3248,417269,-1575864,207,130,0
-432267,-100104,533019,648,-288654,1536901,837,130,0
-347114,225558,122854,1298,1050505,558454,1046,130,0
-56553,-888584,947735,2598,-1368695,1456463,-2,130,0
521319,554470,-1073191,2598,842289,-1632631,1255,130,0
-65328,56098,9229,-1,89757,14767,-1,124,1
1059539,-577872,-478418,3249,-892773,-737973,-211,130,0
-686426,1070590,-383515,649,1612730,-578983,1046,130,0
136505,-31202,-103354,1949,-345630,-1209496,-211,130,0
918,-1390,472,0,-16060,5452,0,124,1
-122855,993237,-869733,649,1498358,-1312347,1046,130,0
987386,-103354,-882084,1948,-159200,-1328057,-1,130,0
347,-664,317,0,-1258,600,-1,124,1
0,0,0,0,0,0,0,124,1
-111805,967236,-856083,-652,1492911,-1320516,1046,130,0
-770929,-277561,1053039,4549,-419155,1576700,417,130,0
735177,-1059540,328262,3899,-1595135,491632,-211,130,0
-134,29,105,0,3396,12138,0,124,1
0,0,0,0,0,0,0,124,1
298361,-966587,669525,1299,-1594716,1104549,-630,130,0
174,-553,378,-1,-15977,10929,-1,124,1
508319,-1061490,555770,2599,-1633469,854229,-421,130,0
85153,55902,-138456,2599,659001,-1623414,627,130,0
78002,-338663,262609,1948,-1558477,1203630,-420,130,0
772228,-1017939,247659,1948,-1566647,381030,-631,130,0
-1058240,750128,308111,-1,1127382,460420,836,130,0
-806031,-93604,902233,2598,-157524,1486837,627,130,0
-46802,-588273,635723,648,-1357593,1465470,-211,130,0
-469318,1080340,-611023,-1,1629278,-920842,1465,130,0
227508,-694227,469317,2598,-1601838,1079203,-630,130,0
0,0,0,0,0,0,0,124,1
-605173,-472568,1084240,6499,-715559,1629488,418,130,0
-288611,-31202,322412,2599,-141395,1479715,208,130,0
-1063440,720877,345162,2599,1084021,516559,1046,130,0
1034838,-768329,-265210,1299,-1167392,-405540,207,130,0
22750,109204,-131305,649,1268357,-1525590,627,130,0
566,-584,17,-1,-1106,32,-1,124,1
-18862,-198133,216996,1,-256407,280818,1,124,1
-133906,-863233,1000387,3248,-1302292,1505270,-2,130,0
369863,185256,-555771,-652,536459,-1604142,-1,130,0
-707877,1036788,-326963,1948,1598695,-506087,1255,130,0
-1041340,250909,791729,1298,377260,1187919,836,130,0
30000,30000,30000,90000,60000,60000,180000,124,1
21850,47314,-69165,-1,75703,-110664,0,124,1
-141056,-210608,353613,1949,-971744,1622784,-211,130,0
0,0,0,0,0,0,0,124,1
-118305,122854,-1951,2598,1439286,-49855,1255,130,0
2568,3080,-5649,-1,8896,-16311,0,124,1
0,-61237,61237,0,-97979,97979,0,124,1
78002,-338013,262609,2598,-1558268,1203630,-420,130,0
1025738,-822931,-201508,1299,-1238194,-303736,-421,130,0
-785230,-254810,1044589,4549,-384592,1567065,628,130,0
-5226,738,4487,-1,2132,12958,0,124,1
-233773,165491,68281,-1,214165,88364,-1,124,1
-352314,205407,148205,1298,950168,676177,1046,130,0
550570,-166407,-386765,-2602,-477179,-1114186,-420,130,0
-435517,-642875,1081640,3248,-968183,1623203,-211,130,0
-204988,-6293,211281,0,-8144,273423,0,124,1
-194500,219631,-25130,1,284228,-32521,0,124,1
235958,109854,-344513,1299,514674,-1599534,208,130,0
-63003,59302,3700,-1,94884,5921,0,124,1
-353614,181356,172906,648,842708,790759,1046,130,0
646,-188,-457,1,-357,-866,0,124,1
-656525,-418616,1079690,4549,-632189,1620271,-1,130,0
254,404,-658,0,766,-1247,0,124,1
7527,1804,-9331,0,5154,-26661,0,124,1
1068640,-640274,-426416,1950,-973630,-648947,-212,130,0
720877,341912,-1062790,-1,512998,-1599115,417,130,0
494018,592822,-1085541,1299,888583,-1630955,418,130,0
445266,622723,-1067991,-2,947444,-1625509,1045,130,0
671475,-1074491,406915,3899,-1617758,611869,-211,130,0
826180,198257,-1023789,648,295147,-1538368,418,130,0
-965287,289910,677325,1948,475502,1115651,626,130,0
-326963,560971,-233359,649,1626345,-676807,1045,130,0
-980887,365313,616873,1299,600767,1015314,627,130,0
-522,73,448,-1,2132,12958,0,124,1
978936,-876233,-102054,649,-1329943,-156686,-2,130,0
-83854,524569,-441367,-652,1521190,-1276108,417,130,0
-430,-103,533,0,-2976,15397,1,124,1
-276261,-769629,1049139,3249,-1159432,1576072,-421,130,0
3325,-5625,2300,0,-16244,6643,-1,124,1
-614924,1080340,-464118,1298,1628650,-700268,1465,130,0
30000,30000,30000,90000,60000,60000,180000,124,1
-524570,-463468,989337,1299,-767299,1632420,-2,130,0
881433,-995188,116354,2599,-1493750,174281,-1,130,0
1073190,-568772,-504419,-1,-864075,-768137,208,130,0
696176,-958786,263909,1299,-1581519,435912,-630,130,0
669525,-140406,-529120,-1,-322379,-1225206,-1,130,0
30000,30000,30000,90000,60000,60000,180000,124,1
-443,5105,-4661,1,14742,-13461,0,124,1
-297062,313311,-13651,2598,1449760,-72059,1255,130,0
-809931,1029638,-219709,-2,1552192,-333272,1464,130,0
-871683,957485,-85154,648,1476782,-133016,1046,130,0
-141056,-210608,352963,1299,-969650,1622994,-421,130,0
-220359,-787180,1010137,2598,-1214314,1553239,207,130,0
-702677,1068640,-364014,1949,1607283,-549447,1046,130,0
-32101,-38511,70613,1,-61618,112982,1,124,1
-351014,1041339,-689676,649,1605817,-1063912,837,130,0
418615,660424,-1076441,2598,991434,-1619643,628,130,0
-304862,-726078,1034188,3248,-1120260,1589478,-420,130,0
0,208206,-208206,0,269443,-269443,0,124,1
54602,-141706,87753,649,-1618805,1000441,-211,130,0
137,-40,-97,0,-4639,-11243,0,124,1
6429,-9733,3304,0,-27810,9441,0,124,1
-46802,-464768,512869,1299,-1341464,1478248,-2,130,0
709176,360113,-1067340,1949,538763,-1604561,-1,130,0
-565,282,282,-1,8167,8167,0,124,1
-137156,40951,99453,3248,470056,1119631,627,130,0
67602,-888584,822280,1298,-1466728,1356335,-420,130,0
9625,-6814,-2811,0,-19469,-8033,0,124,1
-1951,-488819,492068,1298,-1411218,1418130,-630,130,0
-539521,122204,417315,-2,353170,1204677,836,130,0
-844382,-131955,980886,4549,-206750,1506527,836,130,0
646,-188,-457,1,-357,-866,0,124,1
-57853,967236,-908735,648,1456882,-1368276,1046,130,0
-193708,997787,-804081,-2,1540043,-1241964,1046,130,0
0,0,0,0,0,0,0,124,1
431616,98803,-531070,-651,288653,-1536273,418,130,0
-201508,350363,-148856,-1,1627812,-693565,836,130,0
931484,-29252,-902884,-652,-46294,-1390480,208,130,0
204988,6293,-211281,0,8144,-273423,0,124,1
443,4661,-5105,-1,13461,-14742,0,124,1
657824,-556421,-99454,1949,-1284068,-232515,-420,130,0
139755,-41602,-95554,2599,-469638,-1120260,-839,130,0
1396,-506,-889,1,-5853,-10279,1,124,1
918484,-921085,3900,1299,-1417293,5027,-421,130,0
-5379,1176,4203,0,3396,12138,0,124,1
191757,161856,-351014,2599,754520,-1631374,836,130,0
9414,-2058,-7356,0,-5880,-21019,0,124,1
-918485,917184,1950,649,1414569,628,1046,130,0
969186,-57853,-910035,1298,-89445,-1367438,209,130,0
-1051090,765078,289260,3248,1149376,431094,1045,130,0
-806681,-92304,901583,2598,-154172,1485370,627,130,0
-689676,479717,213207,3248,1107691,486395,1255,130,0
-277561,700726,-421216,1949,1622575,-977400,1465,130,0
0,0,0,0,0,0,0,124,1
958785,-924985,-31852,1948,-1390061,-48389,-421,130,0
30000,30000,30000,90000,60000,60000,180000,124,1
-431,-221,653,1,-420,1237,0,124,1
-219709,-341263,561621,649,-986407,1620690,-210,130,0
-113105,-14951,131304,3248,-170511,1491864,418,130,0
-566822,286010,281460,648,823856,809821,837,130,0
1375,-401,-973,1,-4639,-11243,0,124,1
-383515,-663675,1049139,1949,-1023903,1614196,-2,130,0
4301,-5332,1030,-1,-15397,2976,-1,124,1
-304212,-726728,1032888,1948,-1121936,1589059,-211,130,0
730627,299011,-1029639,-1,459164,-1586547,627,130,0
848931,-999088,152755,2598,-1516164,230419,-421,130,0
300311,-316562,17550,1299,-1451227,75619,-420,130,0
-98804,-36402,138455,3249,-419784,1576700,207,130,0
1036788,-709827,-326963,-2,-1094076,-503573,-630,130,0
3059,6624,-9683,0,18925,-27666,-1,124,1
-537,420,117,0,12138,3396,0,124,1
131954,-19501,-110505,1948,-213663,-1295170,208,130,0
-7151,-853482,861282,649,-1408914,1420224,-211,130,0
0,0,0,0,0,0,0,124,1
63003,-3700,-59302,1,-5921,-94884,0,124,1
83,-140,57,0,-16244,6643,-1,124,1
30000,30000,30000,90000,60000,60000,180000,124,1
566171,81903,-648075,-1,190620,-1499615,628,130,0
-137156,96203,41601,648,1125706,462725,1046,130,0
62402,-969187,909384,2599,-1458768,1366180,-2,130,0
1058889,-579822,-477118,1949,-894239,-736506,-210,130,0
-575922,1057589,-481669,-2,1632001,-743210,1464,130,0
-106604,-26651,135205,1950,-295776,1538995,627,130,0
-1069291,701376,369213,1298,1055113,552798,1255,130,0
139105,-99454,-39002,649,-1128220,-459165,-630,130,0
-194500,-25130,219631,1,-32521,284228,0,124,1
-442667,-623374,1072540,6499,-949959,1625926,208,130,0
-140,80,60,0,9251,7032,0,124,1
-20801,315261,-292511,1949,1463376,-1359897,627,130,0
-443,-4661,5105,1,-13461,14742,0,124,1
949685,-18201,-928235,3249,-30165,-1398859,-2,130,0
0,0,0,0,0,0,0,124,1
-370514,976986,-609723,-3251,1617967,-1005679,418,130,0
-521320,449816,72152,648,1301244,205702,1465,130,0
919134,-921085,2600,649,-1416245,2513,-839,130,0
788479,221658,-1007538,2599,339555,-1553031,418,130,0
-155,-482,637,0,-912,1206,1,124,1
247659,-344513,99453,2599,-1586128,453089,-630,130,0
54,86,-140,0,9943,-16194,-1,124,1
-1375,401,973,-1,4639,11243,0,124,1
0,-489,489,0,-14145,14145,0,124,1
585021,397164,-982837,-652,653973,-1622576,1046,130,0
-90354,-893134,984786,1298,-1342301,1477410,-1,130,0
-700727,438116,263259,648,1012800,603490,627,130,0
367,188,-556,-1,5452,-16060,0,124,1
-224259,-784580,1011437,2598,-1209915,1555334,-2,130,0
-563,320,243,0,9251,7032,0,124,1
-370514,-184607,555770,649,-533737,1603722,207,130,0
-439417,985436,-547971,-1952,1630535,-903875,627,130,0
362063,343862,-705927,-2,796624,-1632840,417,130,0
173556,841131,-1015989,-1302,1265005,-1527266,1046,130,0
531069,136505,-668876,-1302,318817,-1546328,627,130,0
63702,-969837,909384,3249,-1459606,1365342,-211,130,0
194500,-219631,25130,-1,-284228,32521,0,124,1
-505069,1058889,-553821,-1,1633468,-853811,1465,130,0
-1951,-939936,944485,2598,-1412684,1417082,-211,130,0
-375715,705276,-326963,2598,1632839,-760596,1255,130,0
-1078391,436166,644174,1949,655021,968811,1047,130,0
-607123,616223,-7151,1949,1425880,-21786,1255,130,0
-110,1276,-1165,1,14742,-13461,0,124,1
596722,27951,-624674,-1,66402,-1446200,417,130,0
-125617,-114716,240333,0,-148456,311020,1,124,1
-470618,1080340,-609723,-1,1629278,-919586,1045,130,0
-450467,1067339,-616224,648,1627183,-939486,1045,130,0
-542121,662374,-117655,2598,1533340,-277552,1256,130,0
-58503,967886,-908085,1298,1457301,-1367648,1046,130,0
366613,-558371,192407,649,-1608122,554474,-629,130,0
354913,-1043290,691625,3248,-1605818,1063073,-840,130,0
222308,-946436,726077,1949,-1560991,1197345,-421,130,0
30000,30000,30000,90000,60000,60000,180000,124,1
988687,-501819,-488819,-1951,-828884,-804376,-421,130,0
569421,518069,-1086191,1299,777353,-1632421,627,130,0
-559671,207357,352963,649,598463,1016989,417,130,0
351663,-133255,-217109,1299,-610613,-1006726,-420,130,0
30000,30000,30000,90000,60000,60000,180000,124,1
30000,30000,30000,90000,60000,60000,180000,124,1
0,0,0,0,0,0,0,124,1
1055639,-703977,-350364,1298,-1069568,-534575,-421,130,0
142355,-81254,-59153,1948,-930059,-697754,-211,130,0
-760529,-167707,930834,2598,-279228,1533549,626,130,0
-559671,206707,352963,-1,596159,1019084,627,130,0
-598673,1080990,-481669,648,1630535,-726242,1256,130,0
-70492,40050,30441,-1,64081,48706,-1,124,1
-20801,-109855,133905,3249,-1265634,1527055,-211,130,0
30000,30000,30000,90000,60000,60000,180000,124,1
586971,499218,-1083591,2598,749283,-1631164,836,130,0
-785880,-238559,1029638,5199,-365740,1561618,626,130,0
216,344,-560,0,9943,-16194,-1,124,1
1300,120904,-120905,1299,1414778,-1414570,836,130,0
943185,-212558,-731278,-651,-351705,-1205306,-210,130,0
-9899,4949,4949,-1,14142,14142,0,124,1
0,208206,-208206,0,269443,-269443,0,124,1
30000,30000,30000,90000,60000,60000,180000,124,1
-136506,96853,40951,1298,1129895,456859,836,130,0
-48102,951635,-903534,-1,1450388,-1376027,1045,130,0
-6999,9562,-2562,1,27320,-7320,1,124,1
-843082,-134556,981536,3898,-210521,1507784,417,130,0
-514170,-569422,1086840,3248,-858420,1632630,417,130,0
675375,397814,-1071241,1948,596997,-1614825,418,130,0
0,122,-122,0,14145,-14145,0,124,1
884,-5281,4396,-1,-15249,12694,0,124,1
74752,-143006,68902,648,-1633469,783637,-630,130,0
-204988,-6293,211281,0,-8144,273423,0,124,1
-328913,560971,-232059,-1,1625717,-672827,1046,130,0
131954,-113755,-17551,648,-1296217,-213034,-420,130,0
-576572,641574,-63703,1299,1484742,-151659,1046,130,0
-45922,-23603,69526,1,-37765,111242,1,124,1
-954886,924984,32501,2599,1391946,45455,1465,130,0
1060189,-508970,-550571,648,-784895,-847736,-1,130,0
2568,-5649,3080,-1,-16311,8896,0,124,1
-685126,191757,495968,2599,441987,1140788,627,130,0
-1041340,250909,792379,1948,376631,1188338,836,130,0
-275611,-769629,1049139,3899,-1159641,1576072,-420,130,0
166406,-1012738,849581,3249,-1522239,1274431,-2,130,0
-125617,240333,-114716,0,311020,-148456,1,124,1
-842432,-132605,980886,5849,-208426,1506946,417,130,0
580471,-642875,64352,1948,-1482648,147049,-421,130,0
1396,-889,-506,1,-10279,-5853,1,124,1
-113105,-233359,349063,2599,-1072501,1603094,-2,130,0
-53953,-86454,141705,1298,-988502,1620061,-211,130,0
213858,-561622,347763,-1,-1617968,1004002,-2,130,0
-505069,33801,473217,1949,95519,1364295,417,130,0
-823581,990637,-164457,2599,1526217,-256605,1673,130,0
-1260,1186,74,0,13698,854,-1,124,1
646774,-1053690,408865,1949,-1620481,628627,-839,130,0
-399,546,-146,1,15777,-4227,1,124,1
-576572,1056939,-479718,649,1631792,-741743,1465,130,0
335412,-268461,-65653,1298,-1232957,-312115,-840,130,0
-646,188,457,-1,357,866,0,124,1
-2955,-2699,5654,0,-7793,16328,1,124,1
658474,417315,-1075791,-2,628627,-1619643,418,130,0
-537,607,-69,1,1149,-131,0,124,1
-607773,615573,-5851,1949,1424414,-19063,836,130,0
352313,-133906,-216459,1948,-610194,-1006936,-211,130,0
343862,-248960,-92304,2598,-1146654,-434447,-630,130,0
0,4898,-4898,0,14145,-14145,0,124,1
-204758,-807981,1019238,6499,-1232119,1545280,208,130,0
-1060840,508319,555120,2599,782589,850878,1255,130,0
-685126,1070590,-383515,1949,1612730,-579192,1047,130,0
-126,7,118,-1,854,13698,-1,124,1
-588273,-393915,984136,1948,-651670,1622784,-211,130,0
-690326,479067,212557,1298,1107901,485767,837,130,0
-63003,3700,59302,-1,5921,94884,0,124,1
508969,-1061490,555120,2599,-1633259,853391,-211,130,0
508969,-681876,174856,1949,-1572093,400511,-421,130,0
592,-557,-34,1,-1055,-65,1,124,1
-1062140,722827,343212,3899,1086325,513627,837,130,0
550570,-166407,-388065,-3902,-474456,-1116280,-420,130,0
143005,-61753,-78003,3249,-704038,-924194,-211,130,0
220358,339962,-562272,-1952,984521,-1620691,626,130,0
-363364,555770,-191758,648,1608750,-555941,1046,130,0
256759,786529,-1042640,648,1182263,-1567066,1045,130,0
0,0,0,0,0,0,0,124,1
-1260,74,1186,0,854,13698,-1,124,1
-1066040,418615,650024,2599,636378,985150,1466,130,0
-113105,127404,-13001,1298,1492911,-171349,1046,130,0
0,0,0,0,0,0,0,124,1
623373,-1083591,464117,3899,-1628232,695449,-630,130,0
-535621,-546021,1086190,4548,-824904,1633468,208,130,0
0,0,0,0,0,0,0,124,1
0,8573,-8573,0,24494,-24494,0,124,1
-83,140,-57,0,16244,-6643,1,124,1
-312662,-391965,707226,2599,-907227,1629697,-2,130,0
0,0,0,0,0,0,0,124,1
-78003,978286,-898984,1299,1470917,-1350890,1046,130,0
-20151,315261,-293161,1949,1462119,-1361992,1046,130,0
30000,30000,30000,90000,60000,60000,180000,124,1
668875,378964,-1045890,1949,581915,-1612102,628,130,0
0,0,0,0,0,0,0,124,1
-182813,226626,-43812,1,293281,-56698,1,124,1
-5639,3204,2435,0,9251,7032,0,124,1
550,-389,-160,1,-11243,-4639,0,124,1
-584372,-497269,1086840,5199,-750332,1631582,207,130,0
579171,-1060840,484268,2599,-1632002,744046,-840,130,0
504,-474,-29,1,-13698,-854,1,124,1
63702,-969187,909384,3899,-1459606,1365133,-420,130,0
-794980,907433,-113755,-1302,1499824,-188526,1046,130,0
-525220,1082290,-556421,649,1633886,-840405,1255,130,0
-125617,240333,-114716,0,311020,-148456,1,124,1
6429,-9733,3304,0,-27810,9441,0,124,1
-132605,104653,31201,3249,1214522,339136,836,130,0
1083590,-508320,-574622,648,-767508,-864913,-210,130,0
-721528,-338013,1066039,6498,-511742,1598905,-1,130,0
-685776,193707,494018,1949,447014,1137017,836,130,0
261959,436166,-698777,-652,1010705,-1616292,417,130,0
156005,-353614,200857,3248,-1629489,916652,-421,130,0
669525,-138456,-530420,649,-318608,-1227929,-1,130,0
-1032889,261309,776779,5199,393599,1176608,1047,130,0
-106604,133254,-24701,1949,1542137,-303736,1255,130,0
170000,62224,-232224,0,80525,-300525,0,124,1
-4576,-591,5167,0,-1707,14922,1,124,1
-1066690,420565,648724,2599,638263,983474,1256,130,0
648724,-84504,-564872,-652,-194182,-1307110,208,130,0
-205,650,-444,1,1231,-842,1,124,1
799529,-907434,109854,1949,-1496892,182031,-420,130,0
936035,-11051,-923035,1949,-19063,-1404305,627,130,0
1043289,-779380,-262610,1299,-1174933,-395275,-420,130,0
-840482,872982,-32502,-2,1442428,-56139,1046,130,0
380914,666924,-1046540,1298,1026625,-1613150,836,130,0
505718,-35102,-472568,-1952,-98243,-1362620,-1,130,0
539520,-122205,-418616,-1301,-348144,-1207611,-2,130,0
349713,-229459,-118955,1299,-1053439,-554684,-840,130,0
9145,-7853,-1292,0,-22439,-3691,1,124,1
-455668,-621424,1081640,4548,-939067,1627183,207,130,0
482318,-499219,18200,1299,-1440125,52158,-420,130,0
-887284,63052,826180,1948,102432,1360734,627,130,0
33,-135,102,0,-15661,11848,0,124,1
-1548,9241,-7693,0,26405,-21981,0,124,1
-204988,-6293,211281,0,-8144,273423,0,124,1
-344513,105953,240509,1949,492889,1102035,627,130,0
366613,-557721,191107,-1,-1607703,551960,-630,130,0
30000,30000,30000,90000,60000,60000,180000,124,1
-39652,507018,-468668,-1302,1470288,-1351937,1046,130,0
-44852,-589573,635073,648,-1360107,1463585,-630,130,0
294461,-1051090,759878,3249,-1582357,1143301,-211,130,0
648074,-1053040,407565,2599,-1620062,626113,-839,130,0
-92304,-437467,529119,-652,-1262492,1528941,-1,130,0
1006237,-865183,-139756,1298,-1298103,-210102,-212,130,0
5547,58274,-63822,-1,93239,-102115,0,124,1
261309,437466,-697477,1298,1012172,-1616082,209,130,0
-333463,1061489,-727378,648,1597648,-1094286,1255,130,0
-884,5281,-4396,1,15249,-12694,0,124,1
1037438,-709827,-326963,648,-1093029,-504830,-421,130,0
30000,30000,30000,90000,60000,60000,180000,124,1
-7000,-2562,9562,0,-7320,27320,0,124,1
496618,589572,-1084891,1299,884393,-1631164,627,130,0
-759229,-170307,931484,1948,-282579,1534596,417,130,0
109204,-133906,27951,3249,-1542557,304363,-839,130,0
-1144,-147,1291,0,-1707,14922,1,124,1
-750129,1053039,-301612,1298,1586755,-455813,1255,130,0
352313,-1042640,693575,3248,-1605190,1065797,-420,130,0
-598673,1080990,-482319,-2,1630535,-727290,1046,130,0
-114,-14,129,1,-1707,14922,1,124,1
-367,556,-188,1,16060,-5452,0,124,1
635073,-590873,-42902,1298,-1361154,-102223,-839,130,0
205,-650,444,-1,-1231,842,-1,124,1
207357,808630,-1014689,1298,1232118,-1544443,1465,130,0
-403016,-143656,546670,-2,-412033,1574815,-1,130,0
-521970,449816,70852,-1302,1301453,205073,1255,130,0
-536271,-546671,1086190,3248,-825532,1633468,418,130,0
-1033539,809280,224908,649,1217874,334737,1465,130,0
-88404,-810581,897683,-1302,-1337903,1480552,-212,130,0
843081,157955,-997138,3898,237960,-1517630,1046,130,0
558370,-358814,-200208,-652,-1035005,-577098,-630,130,0
-1044590,358813,687725,1948,550913,1056161,627,130,0
43,-138,94,-1,-15977,10929,-1,124,1
-1034839,229458,808630,3249,343325,1211590,1046,130,0
-154056,351013,-195658,1299,1629697,-913720,837,130,0
-878833,993237,-113105,1299,1493330,-172187,1255,130,0
826180,-1028989,204757,1948,-1543186,306668,-420,130,0
-63053,-76703,143655,3899,-887536,1630954,-420,130,0
174856,-681226,508319,1949,-1572093,1170533,-630,130,0
-302262,-728028,1032888,2598,-1124659,1588221,-2,130,0
1054989,-434217,-619474,1298,-671151,-953939,-211,130,0
-807331,-93604,901583,648,-156058,1485999,417,130,0
-304212,-3251,308761,1298,-14245,1421691,417,130,0
211907,477767,-688376,1298,1106434,-1593459,836,130,0
-60290,-1850,62141,1,-2961,99426,0,124,1
64352,-969837,908734,3249,-1460235,1364714,-211,130,0
5200,938635,-943186,649,1411845,-1417502,1255,130,0
-1087491,547970,542770,3249,822180,811706,1255,130,0
986736,-102704,-882734,1298,-157105,-1329314,-1,130,0
1084890,-562272,-521970,648,-846899,-786151,-420,130,0
638323,-1082941,448516,3898,-1625718,671569,-630,130,0
361413,345162,-705927,648,798509,-1632840,627,130,0
470,-642,172,0,-1215,325,0,124,1
5226,-4487,-738,1,-12958,-2132,0,124,1
-140406,-211258,352963,1299,-973001,1622575,-211,130,0
-970487,113104,859982,2599,172814,1320306,1046,130,0
-525870,-462168,989337,1299,-764576,1632420,208,130,0
-710477,-356214,1071240,4549,-538136,1604560,208,130,0
-1051740,765728,286660,648,1152309,427114,1255,130,0
295,269,-565,-1,7793,-16328,-1,124,1
849581,-999088,152755,3248,-1515954,229791,-211,130,0
-263260,-436167,702026,2599,-1009030,1616710,-420,130,0
70492,-30441,-40050,1,-48706,-64081,1,124,1
-141056,70202,72152,1298,821551,812125,836,130,0
67249,-14701,-52548,0,-23522,-84077,0,124,1
83,57,-140,0,6643,-16244,-1,124,1
-253510,-85804,342562,3248,-395485,1570207,208,130,0
-92003,-146356,238359,0,-189402,308465,0,124,1
-1144,-147,1291,0,-1707,14922,1,124,1
-422516,700726,-275611,2599,1622365,-642663,1255,130,0
375064,-1069291,697476,3249,-1609379,1048620,-1,130,0
-300312,-749479,1054989,5198,-1131991,1586127,-1,130,0
-32502,133905,-101404,-1,1564970,-1188339,627,130,0
30000,30000,30000,90000,60000,60000,180000,124,1
0,-575,575,0,-1090,1090,0,124,1
-216,-344,560,0,-9943,16194,1,124,1
-1084241,618173,468667,2599,927335,701524,1256,130,0
0,0,0,0,0,0,0,124,1
52,-599,547,0,-1136,1037,-1,124,1
-6429,-3304,9733,0,-9441,27810,0,124,1
65328,-56098,-9229,1,-89757,-14767,1,124,1
-731928,1057589,-324363,1298,1594925,-490167,1255,130,0
3059,6624,-9683,0,18925,-27666,-1,124,1
65328,-56098,-9229,1,-89757,-14767,1,124,1
-9101,126104,-115705,1298,1473430,-1347538,836,130,0
911984,-791080,-120255,649,-1305644,-197533,-630,130,0
-74292,-160869,235162,1,-208184,304328,1,124,1
11,116,-127,0,13461,-14742,0,124,1
-896384,959435,-61103,1948,1460862,-96567,1465,130,0
5040,-4744,-296,0,-13698,-854,1,124,1
-194500,219631,-25130,1,284228,-32521,0,124,1
-933435,29251,906133,1949,42941,1392783,836,130,0
0,8573,-8573,0,24494,-24494,0,124,1
-216,-344,560,0,-9943,16194,1,124,1
-1005588,177456,832681,4549,268334,1261444,836,130,0
-323063,283410,41601,1948,1313812,184545,1255,130,0
564871,-323063,-241160,648,-931526,-696288,-421,130,0
482,14,-497,-1,427,-14354,0,124,1
0,0,0,0,0,0,0,124,1
-228649,178664,49985,0,231212,64686,-1,124,1
721527,342562,-1062140,1949,512998,-1599115,417,130,0
-126755,539520,-413416,-651,1562666,-1194414,836,130,0
45922,-69526,23603,-1,-111242,37765,-1,124,1
-1084241,470617,617523,3899,706341,922727,1046,130,0
-563,320,243,0,9251,7032,0,124,1
-566,-17,584,1,-32,1106,1,124,1
8820,-518,-8302,0,-1480,-23721,0,124,1
-99,136,-36,1,15777,-4227,1,124,1
1260,-1186,-74,0,-13698,-854,1,124,1
0,0,0,0,0,0,0,124,1
228649,-49985,-178664,0,-64686,-231212,1,124,1
-244410,341262,-96204,648,1586336,-453299,1465,130,0
-103,-516,620,1,-978,1175,1,124,1
-525220,1071890,-545371,1299,1633886,-831188,1464,130,0
-44,510,-466,0,14742,-13461,0,124,1
161856,763778,-926935,-1301,1261235,-1529361,836,130,0
164456,761828,-928235,-1951,1258092,-1531036,836,130,0
365963,-557071,192407,1299,-1608332,554264,-840,130,0
969186,-61103,-907434,649,-93844,-1364715,627,130,0
1075140,-684476,-388065,2599,-1029349,-584010,-420,130,0
-764429,1050439,-284711,1299,1580261,-430257,1255,130,0
469,-642,172,-1,-1215,325,-1,124,1
0,0,0,0,0,0,0,124,1
121554,-664325,544720,1949,-1532922,1255160,-211,130,0
-295112,962686,-670826,-3252,1594296,-1106645,627,130,0
-746228,934735,-188508,-1,1545280,-312534,1256,130,0
939935,-924985,-13651,1299,-1402839,-23671,-211,130,0
110,-1276,1165,-1,-14742,13461,0,124,1
614,-86,-527,1,-164,-998,0,124,1
378964,-707877,331512,2599,-1632840,761852,-839,130,0
-522,448,73,-1,12958,2132,0,124,1
-390,661,-270,1,1251,-511,1,124,1
4823,148,-4971,0,427,-14354,0,124,1
141,-70,-70,1,-8167,-8167,0,124,1
336062,225558,-562272,-652,653554,-1622995,417,130,0
-131955,104653,30551,3249,1217036,335784,1046,130,0
115704,-130005,17550,3249,-1495635,178051,-630,130,0
-393265,1071240,-677976,-1,1615243,-1020970,1255,130,0
105303,-345163,243109,3249,-1591993,1112928,-630,130,0
336712,-1064090,729327,1949,-1597858,1094494,-421,130,0
-278211,-768329,1049139,2599,-1157966,1576700,-421,130,0
0,-575,575,0,-1090,1090,0,124,1
-1032239,263909,774829,6499,397998,1173465,1255,130,0
398464,-548621,150805,648,-1580891,433189,-630,130,0
811880,-1033539,223608,1949,-1552822,335575,-630,130,0
-981537,888583,96203,3249,1339158,141603,1464,130,0
-806681,-95554,902233,-2,-158781,1487256,418,130,0
625973,-29902,-596723,-652,-67451,-1379378,-2,130,0
-74753,335412,-258060,2599,1558686,-1202583,627,130,0
-929535,-21451,955535,4549,-35192,1431955,837,130,0
178756,373764,-554471,-1951,1084440,-1599743,418,130,0
-1085541,564871,523919,3249,848783,784894,1465,130,0
-1375,973,401,-1,11243,4639,0,124,1
700726,-438767,-261310,649,-1012173,-604539,-631,130,0
-455668,516769,-62403,-1302,1497729,-183080,1045,130,0
60290,1850,-62141,-1,2961,-99426,0,124,1
-939936,742327,195657,-1952,1225834,322797,1046,130,0
-686426,1069940,-382215,1299,1612520,-577936,836,130,0
748178,-938636,189157,-1301,-1545699,314627,-630,130,0
-32502,-102704,137155,1949,-1179960,1568112,-211,130,0
-40302,507669,-467368,-1,1470917,-1351099,628,130,0
-9777,6229,3547,-1,17799,10136,-1,124,1
-7801,614923,-606473,649,1425671,-1403468,1046,130,0
-993238,876232,119604,2598,1318630,176376,1256,130,0
432266,98803,-531720,-651,287605,-1535854,208,130,0
963336,-290561,-674726,-1951,-480112,-1111882,-212,130,0
-595423,1080990,-485569,-2,1630954,-732526,1256,130,0
-106604,132604,-24701,1299,1541718,-302060,1046,130,0
-45502,949685,-905484,-1301,1447665,-1378959,1255,130,0
694876,-960086,265209,-1,-1582148,438007,-630,130,0
-9751,126754,-115705,1298,1474478,-1345863,836,130,0
-371814,978286,-608423,-1951,1618385,-1003375,626,130,0
532369,-1075791,547320,3898,-1634097,830140,-211,130,0
-33152,-911985,950335,5198,-1387338,1441172,208,130,0
-634424,973086,-339963,-1301,1609797,-562225,627,130,0
174,-553,378,-1,-15977,10929,-1,124,1
93603,46151,-137806,1948,545257,-1605818,-1,130,0
-432917,-99454,532369,-2,-287188,1536272,626,130,0
-729328,1058889,-327613,1948,1596391,-495822,1465,130,0
41562,-70323,28760,-1,-112517,46016,-1,124,1
-341263,246359,96853,1949,1143301,439473,1255,130,0
3673,1888,-5562,-1,5452,-16060,0,124,1
45501,-139756,96853,2598,-1597649,1095123,-839,130,0
-532370,-136506,672125,3249,-317980,1546327,418,130,0
649374,-83854,-566172,-652,-192925,-1307738,208,130,0
-239675,103501,136173,-1,133943,176224,0,124,1
233773,-68281,-165491,1,-88364,-214165,1,124,1
-155,-482,637,0,-912,1206,1,124,1
50701,-329563,280810,1948,-1515116,1286790,-420,130,0
16507,51291,-67798,0,82066,-108478,-1,124,1
531069,136505,-668226,-652,318189,-1546328,418,130,0
208657,-1025089,819680,3248,-1544233,1234003,208,130,0
1084240,-471268,-611673,1299,-710113,-918957,-420,130,0
-21850,-47314,69165,1,-75703,110664,0,124,1
172256,-553821,382214,649,-1595973,1100569,-211,130,0
-1053690,341262,716326,3898,516978,1083811,836,130,0
108554,-133906,27301,1949,-1542557,304573,-629,130,0
174856,-681226,508319,1949,-1572093,1170952,-839,130,0
753378,-1056940,306161,2599,-1587803,460002,-210,130,0
-853482,-148856,1007537,5199,-227488,1514696,836,130,0
-61753,968536,-906784,-1,1459396,-1365343,1047,130,0
771578,-1018589,248959,1948,-1566647,382078,-420,130,0
482,14,-497,-1,427,-14354,0,124,1
-286011,1047839,-760529,1299,1580680,-1147492,836,130,0
56124,174391,-230515,0,225683,-298314,0,124,1
523919,-79303,-446567,-1951,-226022,-1287629,-2,130,0
-670826,-375065,1048489,2598,-580030,1612101,-1,130,0
-830082,-191758,1025088,3248,-289701,1537110,837,130,0
-1018589,768978,250259,648,1184986,382078,1465,130,0
917184,-139756,-780030,-2602,-229583,-1285325,-2,130,0
9868,-5607,-4261,0,-16020,-12176,1,124,1
400,146,-546,0,4227,-15777,0,124,1
787829,221658,-1006888,2599,339345,-1552612,836,130,0
139105,-98154,-39002,1949,-1124869,-463773,-840,130,0
957485,-876883,-79303,1299,-1349424,-123170,-839,130,0
640273,-976987,336712,-2,-1608541,555940,-630,130,0
254809,-564872,311361,1298,-1630745,900104,-210,130,0
-691626,956835,-266510,-1301,1582985,-440312,1256,130,0
-297712,963986,-668876,-2602,1595134,-1103712,836,130,0
942535,-923035,-16901,2599,-1400116,-28908,-2,130,0
104653,-345813,243109,1949,-1591155,1116070,-420,130,0
-520670,451116,70202,648,1303339,202141,1256,130,0
-785880,-237909,1029638,5849,-364274,1561409,836,130,0
-599973,1069290,-468668,649,1629697,-714931,1255,130,0
697476,-247660,-449167,649,-569976,-1040661,-421,130,0
-312012,1054989,-743628,-651,1590316,-1119632,1046,130,0
334762,-1063440,731277,2599,-1597230,1096798,-631,130,0
-1034839,231408,807980,4549,345420,1210123,836,130,0
-154056,351013,-195658,1299,1629697,-912882,627,130,0
-189158,-164457,354913,1298,-756616,1631792,-1,130,0
-460868,-55903,516119,-652,-161923,1488722,627,130,0
-999,1366,-366,1,15777,-4227,1,124,1
749478,-937986,187857,-651,-1544862,311904,-631,130,0
-277561,701376,-419916,3899,1622784,-976562,1255,130,0
312011,392614,-704627,-2,909111,-1629489,626,130,0
-928885,-22751,955535,3899,-37496,1433002,627,130,0
-493369,-191108,687075,2598,-444083,1582985,-211,130,0
191757,161206,-351014,1949,753682,-1631583,417,130,0
-128705,540170,-412116,-651,1564551,-1190015,836,130,0
224908,-947086,724777,2599,-1562457,1194203,-420,130,0
841781,174206,-1014038,1949,260374,-1526009,1046,130,0
-559671,207357,352963,649,597835,1017618,628,130,0
-596073,1080340,-484919,-652,1630744,-731479,1046,130,0
-88,-439,528,1,-12694,15249,0,124,1
1056289,-704627,-350364,1298,-1070615,-533108,-210,130,0
-174,553,-378,1,15977,-10929,1,124,1
-50000,-18301,68301,0,-29282,109282,0,124,1
794979,-1027689,234008,1298,-1558896,355684,-1,130,0
1061489,-331513,-728028,1948,-500640,-1096171,-420,130,0
-75403,335412,-258060,1949,1558686,-1202793,836,130,0
-22101,-927585,954235,4549,-1396345,1432583,-630,130,0
281460,-703327,424465,2598,-1622366,977818,-629,130,0
-9414,2058,7356,0,5880,21019,0,124,1
-170000,-62224,232224,0,-80525,300525,0,124,1
938635,-743628,-195008,-1,-1226673,-320703,-211,130,0
65328,-56098,-9229,1,-89757,-14767,1,124,1
460867,53952,-514820,-1,156895,-1486000,418,130,0
457,-516,59,0,-14922,1707,-1,124,1
-877533,993887,-113755,2599,1494168,-174491,1046,130,0
66302,74752,-138456,2598,884184,-1631164,628,130,0
-646,457,188,-1,866,357,0,124,1
109204,-134556,27301,1949,-1541510,301850,-211,130,0
1064089,-717627,-344513,1949,-1081717,-519283,-210,130,0
-603873,-451117,1059539,4549,-697963,1628021,627,130,0
143005,-72153,-68903,1949,-818410,-814849,-420,130,0
493368,591522,-1084891,-1,887116,-1630955,836,130,0
30000,30000,30000,90000,60000,60000,180000,124,1
516119,570721,-1083591,3249,856952,-1632421,417,130,0
396514,-1074491,681225,3248,-1615035,1021807,-630,130,0
-1260,74,1186,0,854,13698,-1,124,1
365963,690975,-1056290,648,1051762,-1607703,837,130,0
-700077,438116,262609,648,1014476,602024,1256,130,0
-1020539,191757,833331,4549,285301,1250342,627,130,0
-172257,678625,-504419,1949,1572720,-1169905,1046,130,0
-60290,62141,-1850,1,99426,-2961,0,124,1
0,0,0,0,0,0,0,124,1
1051089,-648075,-403016,-2,-998138,-621087,-840,130,0
-430,-103,533,0,-2976,15397,1,124,1
4494,-9885,5391,0,-28245,15404,-1,124,1
1059539,-507670,-552521,-652,-783428,-849412,-420,130,0
-211908,558370,-346463,-1,1618176,-1003584,418,130,0
122204,1950,-122205,1949,37076,-1432375,208,130,0
-1086191,490768,596072,649,737553,893610,837,130,0
796929,-1038089,243109,1949,-1562038,365948,-211,130,0
-274311,-770929,1047839,2599,-1161527,1575444,-2,130,0
22,109,-132,-1,12694,-15249,0,124,1
1000,-1366,366,0,-15777,4227,0,124,1
126,-118,-7,1,-13698,-854,1,124,1
-511570,987386,-477768,-1952,1633677,-788875,1255,130,0
-972437,96203,882733,6499,143907,1337483,1046,130,0
30000,30000,30000,90000,60000,60000,180000,124,1
881433,109204,-989988,649,162131,-1488513,208,130,0
-140406,79302,61752,648,927964,700686,1047,130,0
-234009,-112455,348413,1949,-515722,1599742,-211,130,0
174206,-681226,508969,1949,-1571465,1171790,-211,130,0
-882084,-107905,993237,3248,-164018,1489350,626,130,0
1300,939935,-941236,-1,1414150,-1414988,837,130,0
919134,-921085,3250,1299,-1416664,3770,-420,130,0
3788,-9814,6026,0,-28042,17218,-1,124,1
-1085541,562921,525869,3249,845222,788245,1255,130,0
-841782,-171607,1017288,3899,-260166,1526636,626,130,0
16507,51291,-67798,0,82066,-108478,-1,124,1
30000,30000,30000,90000,60000,60000,180000,124,1
-847632,1008837,-159256,1949,1520562,-242360,1256,130,0
23400,-132605,111804,2599,-1523286,1272546,-2,130,0
-501819,475817,26000,-2,1376026,75200,1256,130,0
-310712,299011,13650,1949,1387756,53206,1256,130,0
985436,-568772,-417316,-652,-938857,-687909,-211,130,0
-936686,-3901,945785,5198,-9217,1419177,627,130,0
0,575,-575,0,1090,-1090,0,124,1
-848932,-17551,867782,1299,-31212,1430070,627,130,0
-371164,1067339,-694877,1298,1609378,-1047992,837,130,0
-597373,-27952,627923,2598,-64728,1445571,208,130,0
30000,30000,30000,90000,60000,60000,180000,124,1
30000,30000,30000,90000,60000,60000,180000,124,1
597372,29251,-625324,1299,66612,-1446200,418,130,0
30000,30000,30000,90000,60000,60000,180000,124,1
541,-1402,860,-1,-16194,9943,-1,124,1
380264,687725,-1069291,-1302,1037099,-1611055,418,130,0
347,317,-664,0,600,-1258,-1,124,1
-925635,956185,-29252,1298,1437401,-45666,1464,130,0
-1015989,836581,182656,3248,1259140,272523,1465,130,0
-646,457,188,-1,866,357,0,124,1
-11061,66014,-54952,1,105622,-87924,0,124,1
1033538,-810581,-222309,648,-1218294,-333900,-630,130,0
-224259,690975,-465418,1298,1601837,-1078994,837,130,0
68902,-889234,821630,1298,-1467357,1355288,-2,130,0
-599973,1069290,-468018,1299,1629697,-713674,1465,130,0
30000,30000,30000,90000,60000,60000,180000,124,1
315261,-1057590,745577,3248,-1590317,1119422,-629,130,0
-854783,-148206,1006887,3898,-224555,1513649,1046,130,0
-128055,348413,-218409,1949,1616081,-1015315,626,130,0
-458918,-529120,989337,1299,-875806,1632001,-2,130,0
0,0,0,0,0,0,0,124,1
917834,-921735,5850,1949,-1418550,6703,-839,130,0
-967887,911984,56552,649,1372465,81694,1256,130,0
880782,109854,-989988,648,162550,-1488513,208,130,0
360763,345162,-705927,-2,799976,-1632840,837,130,0
-598673,1080340,-482319,-652,1630535,-726661,1256,130,0
-7801,616223,-605823,2599,1425671,-1403258,1046,130,0
898333,-963987,68902,3248,-1463796,103688,-2,130,0
-572022,-514170,1088790,2598,-774212,1632839,417,130,0
260009,305511,-565522,-2,884393,-1631164,627,130,0
-4000,-1464,5464,0,-4227,15777,0,124,1
503768,-477118,-26001,649,-1375398,-75830,-630,130,0
-843732,995837,-149506,2599,1516163,-230211,1465,130,0
329562,-707877,380264,1949,-1632421,874757,-421,130,0
546020,-664975,120904,1949,-1532712,276294,-420,130,0
-114405,-232709,349063,1949,-1070615,1603722,-211,130,0
657174,421215,-1076441,1948,631141,-1619853,418,130,0
-170000,-62224,232224,0,-80525,300525,0,124,1
656,-418,-238,0,-792,-451,0,124,1
-1015339,837881,180706,3248,1261025,269172,1046,130,0
-69840,44499,25340,-1,71199,40544,-1,124,1
-228649,178664,49985,0,231212,64686,-1,124,1
-805381,-94904,902233,1948,-158990,1487465,627,130,0
1039388,-248960,-789780,648,-376632,-1188130,-211,130,0
11,116,-127,0,13461,-14742,0,124,1
380264,666924,-1046540,648,1025787,-1613359,417,130,0
-21850,69165,-47314,1,110664,-75703,0,124,1
-442017,986086,-546021,-1952,1630954,-900105,1046,130,0
-171607,551220,-379615,-2,1596810,-1098056,418,130,0
-1060840,580471,481668,1299,892982,738600,1256,130,0
-275611,-770279,1048489,2599,-1160898,1575653,-211,130,0
-391965,1071890,-678626,1299,1615034,-1022227,1465,130,0
580471,-643525,65002,1948,-1483067,148516,-210,130,0
0,122,-122,0,14145,-14145,0,124,1
-938636,920434,20800,2598,1400324,29116,1464,130,0
23400,-132605,111804,2599,-1522448,1273593,-421,130,0
-53302,-87104,141055,649,-992063,1619642,-211,130,0
755978,172256,-930185,-1951,283835,-1534388,627,130,0
-460868,-617524,1082290,3898,-932992,1628021,417,130,0
-470,642,-172,0,1215,-325,0,124,1
-704627,296411,410815,2599,683509,943255,837,130,0
-1205,1242,-37,0,14354,-427,0,124,1
-127405,986086,-858033,648,1502547,-1306482,1464,130,0
-141056,70202,72152,1298,819876,813801,837,130,0
986086,-100754,-884034,1298,-154591,-1330571,418,130,0
563,-320,-243,0,-9251,-7032,0,124,1
-796280,906783,-110505,-2,1498358,-184546,1046,130,0
798879,-908735,112454,2598,-1498359,185592,-212,130,0
88,439,-528,-1,12694,-15249,0,124,1
-8820,8302,518,0,23721,1480,0,124,1
141313,97786,-239099,0,126546,-309422,-1,124,1
-11061,-54952,66014,1,-87924,105622,0,124,1
4576,-5167,591,0,-14922,1707,-1,124,1
-182813,-43812,226626,1,-56698,293281,1,124,1
1060189,-505069,-554471,649,-779239,-853811,-630,130,0
468017,-694877,228808,1948,-1602885,526823,-420,130,0
-537,117,420,0,3396,12138,0,124,1
284060,-327613,44851,1298,-1503386,197323,-630,130,0
700076,-438117,-261960,-1,-1009868,-606843,-420,130,0
172906,-553821,380914,-1,-1596392,1099312,-421,130,0
-936036,-4551,946435,5848,-10055,1419596,627,130,0
-169999,232224,-62224,1,300525,-80525,1,124,1
-9625,6814,2811,0,19469,8033,0,124,1
226858,-694227,468667,1298,-1601629,1079622,-630,130,0
442016,-989338,547320,-2,-1630536,903665,-420,130,0
107,-133,25,-1,-15397,2976,-1,124,1
-849582,-14951,866482,1949,-27022,1427765,418,130,0
390,-661,270,-1,-1251,511,-1,124,1
-1054340,705926,352313,3899,1071452,532689,1046,130,0
-399,-146,546,1,-4227,15777,1,124,1
-878183,833981,44201,-1,1378330,71011,1046,130,0
191757,161206,-351014,1949,756615,-1631583,627,130,0
-271711,1022488,-750129,648,1577329,-1157128,1046,130,0
135855,-31202,-104004,649,-341860,-1212219,-211,130,0
-1260,1186,74,0,13698,854,-1,124,1
-253510,562921,-310062,-651,1631373,-897381,1047,130,0
-776,8935,-8158,1,25528,-23309,0,124,1
-53953,-86454,141705,1298,-991854,1619642,-212,130,0
-288611,1048489,-758579,1299,1581518,-1144769,836,130,0
443,-5105,4661,-1,-14742,13461,0,124,1
4576,591,-5167,0,1707,-14922,-1,124,1
-65328,9229,56098,-1,14767,89757,-1,124,1
27059,43045,-70105,-1,68873,-112169,-1,124,1
-599973,-24701,627273,2599,-60748,1443685,417,130,0
-214212,201630,12582,0,260933,16283,0,124,1
105953,-345813,242459,2599,-1592621,1111252,-839,130,0
-493369,-189158,687075,4548,-439684,1582147,208,130,0
9868,-5607,-4261,0,-16020,-12176,1,124,1
-350364,131954,219708,1298,614592,1003374,627,130,0
5500,-1606,-3893,1,-4639,-11243,0,124,1
-146256,1003637,-857383,-2,1512183,-1291190,837,130,0
54,-140,86,0,-16194,9943,-1,124,1
-422516,700726,-276261,1949,1622575,-643082,1674,130,0
-174,553,-378,1,15977,-10929,1,124,1
600622,-1084241,486868,3249,-1630955,731269,-1,130,0
-52002,138455,-84504,1949,1619852,-994786,1256,130,0
131954,-114405,-16901,648,-1298312,-209473,-630,130,0
811230,-1034189,224908,1949,-1553031,337251,-210,130,0
300311,-315262,16900,1949,-1449133,71220,-421,130,0
0,0,0,0,0,0,0,124,1
455667,532369,-988038,-2,878947,-1631374,627,130,0
-1085541,472567,614923,1949,709065,920213,1046,130,0
1066689,-421216,-645475,-2,-639940,-981380,-211,130,0
884683,-59803,-826181,-1301,-100338,-1361573,-211,130,0
452416,243759,-695527,648,564319,-1609170,627,130,0
958785,-874283,-82554,1948,-1345863,-129036,-631,130,0
30000,30000,30000,90000,60000,60000,180000,124,1
226858,-349714,125454,2598,-1611474,572488,-421,130,0
93603,46151,-137156,2598,544419,-1605399,627,130,0
-40302,507018,-468018,-1302,1470079,-1352147,836,130,0
0,0,0,0,0,0,0,124,1
-221009,944485,-724128,-652,1562456,-1194623,836,130,0
-563,320,243,0,9251,7032,0,124,1
930184,-27952,-902884,-652,-44409,-1391528,-2,130,0
-750129,1053039,-301612,1298,1586965,-456023,1255,130,0
-969837,113754,859982,3899,172814,1320306,1046,130,0
353613,-1043290,692275,2598,-1605399,1064540,-420,130,0
1073190,-495319,-577872,-1,-752636,-878948,208,130,0
0,0,0,0,0,0,0,124,1
747528,-938636,190457,-651,-1546118,315465,-420,130,0
127404,-9101,-117005,1298,-91959,-1365972,-2,130,0
-90354,137805,-46152,1299,1607283,-549447,1046,130,0
-85154,525219,-440717,-652,1522447,-1274013,1046,130,0
-521320,450466,70202,-652,1302291,203607,1255,130,0
-1019889,193707,831381,5199,288653,1248247,836,130,0
5226,-738,-4487,1,-2132,-12958,0,124,1
-364664,555120,-190458,-2,1607912,-551333,1046,130,0
205,-650,444,-1,-1231,842,-1,124,1
-6501,-852832,861282,1949,-1408704,1420643,-630,130,0
-128705,17550,114404,3249,214081,1295379,837,130,0
831,575,-1406,0,6643,-16244,-1,124,1
-52002,138455,-85804,649,1619433,-997509,1256,130,0
676025,-520670,-153406,1949,-1202583,-356314,-840,130,0
648074,323712,-971137,649,532270,-1603095,-1,130,0
-457618,-531070,989337,649,-876644,1632001,-2,130,0
137,-97,-40,0,-11243,-4639,0,124,1
537,-420,-117,0,-12138,-3396,0,124,1
0,0,0,0,0,0,0,124,1
313961,-300962,-9751,3248,-1387129,-54254,-840,130,0
-44852,-913935,963336,4549,-1378331,1448503,208,130,0
-1320,-4103,5423,0,-11848,15661,0,124,1
-1051090,765728,287310,1948,1150633,429209,1046,130,0
-1077091,656524,422515,1948,987244,634073,1464,130,0
564221,-325663,-239209,-651,-936553,-691051,-630,130,0
-839182,-157956,1002987,5849,-242360,1520143,628,130,0
255459,-564872,311361,1948,-1630745,898847,-210,130,0
-893134,-87104,983486,3248,-132597,1476363,627,130,0
174,378,-553,-1,10929,-15977,-1,124,1
125617,-240333,114716,0,-311020,148456,-1,124,1
-896384,975686,-76053,3249,1470707,-118562,1465,130,0
90353,893133,-981537,1949,1342719,-1476573,1255,130,0
-809931,1029638,-219059,648,1551983,-332643,1465,130,0
-331513,1061489,-728028,1948,1597229,-1096799,837,130,0
459567,53301,-514820,-1952,156476,-1485790,418,130,0
-128705,348413,-217759,1949,1616500,-1014267,627,130,0
-22,132,-109,1,15249,-12694,0,124,1
378314,-1061490,686425,3249,-1611264,1041498,-210,130,0
77352,-338013,263259,2598,-1558058,1204467,-421,130,0
-520020,-549921,1076440,6499,-839567,1633468,208,130,0
522619,-451117,-70203,1299,-1301873,-203817,-629,130,0
103,-620,516,-1,-1175,978,-1,124,1
0,0,0,0,0,0,0,124,1
-191758,997787,-805381,648,1539624,-1242802,1046,130,0
-2568,-3080,5649,1,-8896,16311,0,124,1
-347,664,-317,0,1258,-600,1,124,1
-135856,96853,40951,1948,1127172,460420,626,130,0
343212,-248960,-92954,1298,-1148120,-432562,-630,130,0
-924985,956835,-31852,-2,1439077,-49436,1256,130,0
0,489,-489,0,14145,-14145,0,124,1
127404,-9101,-116355,1948,-88398,-1367857,418,130,0
550,-389,-160,1,-11243,-4639,0,124,1
5172,4723,-9896,-1,13496,-28274,0,124,1
1414,-707,-707,0,-8167,-8167,0,124,1
-61753,968536,-906134,649,1460024,-1364715,1046,130,0
-91004,-438117,529119,-2,-1264378,1528103,-211,130,0
-1030939,261309,776779,7149,394018,1176189,1047,130,0
-124155,117004,9100,1949,1370789,85045,1465,130,0
30000,30000,30000,90000,60000,60000,180000,124,1
30000,30000,30000,90000,60000,60000,180000,124,1
364663,-557721,193057,-1,-1608751,556778,-630,130,0
101403,-137156,38351,2598,-1578796,425229,-420,130,0
432916,98153,-531720,-651,285301,-1535226,-2,130,0
934735,-6501,-924985,3249,-12150,-1408076,417,130,0
770278,-1053040,284710,1948,-1579215,426695,-211,130,0
1084240,-471918,-611023,1299,-710532,-918119,208,130,0
102053,-137806,38351,2598,-1578796,425229,-420,130,0
0,0,0,0,0,0,0,124,1
-31852,-102704,137155,2599,-1180589,1567903,-420,130,0
-9625,6814,2811,0,19469,8033,0,124,1
689025,-1073841,388714,3898,-1613359,582962,-630,130,0
706576,-348414,-358164,-2,-802490,-831188,-839,130,0
334112,226858,-562272,-1302,657953,-1623204,418,130,0
-99454,-37052,138455,1949,-418946,1576491,417,130,0
0,122,-122,0,14145,-14145,0,124,1
-288611,1048489,-758579,1299,1581937,-1144350,836,130,0
22750,109204,-131305,649,1266681,-1526218,1047,130,0
48751,462167,-511570,-652,1339787,-1479087,627,130,0
30000,30000,30000,90000,60000,60000,180000,124,1
-878833,833981,44851,-1,1377911,72058,1255,130,0
-526520,1071890,-544721,649,1633886,-830141,1045,130,0
964636,-289911,-674726,-1,-479693,-1112300,-420,130,0
-614,86,527,-1,164,998,0,124,1
30000,30000,30000,90000,60000,60000,180000,124,1
0,-61237,61237,0,-97979,97979,0,124,1
30000,30000,30000,90000,60000,60000,180000,124,1
-67249,14701,52548,0,23522,84077,0,124,1
5172,4723,-9896,-1,13496,-28274,0,124,1
902233,-974387,75402,3248,-1467776,112905,-2,130,0
-134,105,29,0,12138,3396,0,124,1
-351664,204757,148205,1298,951005,674920,835,130,0
-43,-94,138,1,-10929,15977,1,124,1
63003,-59302,-3700,1,-94884,-5921,0,124,1
-18862,216996,-198133,1,280818,-256407,1,124,1
430316,-536271,106603,648,-1543186,306877,-421,130,0
1064089,-350364,-711777,1948,-530595,-1072501,-212,130,0
-74103,335412,-259360,1949,1557429,-1205725,1046,130,0
-35752,-910685,950985,4548,-1385662,1442847,208,130,0
-8440,8699,-259,0,24856,-740,0,124,1
457617,529769,-988688,-1302,876014,-1631583,836,130,0
30000,30000,30000,90000,60000,60000,180000,124,1
5587,-3559,-2027,1,-10279,-5853,1,124,1
-558,202,355,-1,5853,10279,-1,124,1
1053689,-341263,-711127,1299,-519493,-1081299,-212,130,0
216,-560,344,0,-16194,9943,-1,124,1
-53768,-12885,66654,1,-20617,106647,0,124,1
-271061,1021838,-750779,-2,1577119,-1158384,1046,130,0
-967237,912634,54602,-1,1373721,79390,1465,130,0
-134,29,105,0,3396,12138,0,124,1
-542771,662374,-117005,2598,1532502,-275667,1046,130,0
-1083591,510269,576571,3249,766670,866169,1256,130,0
1080340,-636374,-443967,-1,-957500,-667799,-629,130,0
0,0,0,0,0,0,0,124,1
-226209,691625,-464768,648,1602884,-1075852,836,130,0
558,-355,-202,1,-10279,-5853,1,124,1
228649,-178664,-49985,0,-231212,-64686,1,124,1
-563,320,243,0,9251,7032,0,124,1
-733228,-297062,1032238,1948,-458955,1586965,209,130,0
130,-112,-18,0,-12958,-2132,0,124,1
-91,139,-47,1,16060,-5452,0,124,1
-911985,965286,-52002,1299,1454159,-81066,1465,130,0
-928235,-22751,956185,5199,-37287,1433002,836,130,0
-171607,677975,-506369,-1,1571254,-1172629,836,130,0
520019,553820,-1073191,648,841870,-1632421,1046,130,0
437,946,-1383,0,10929,-15977,-1,124,1
785879,222308,-1007538,649,340602,-1553240,627,130,0
-233773,68281,165491,-1,88364,214165,-1,124,1
-1074491,391964,685775,3248,586942,1026625,627,130,0
-22,132,-109,1,15249,-12694,0,124,1
111154,879482,-989338,1298,1323448,-1490818,1046,130,0
443,-5105,4661,-1,-14742,13461,0,124,1
566821,-287961,-279511,-651,-827418,-806261,-630,130,0
-1067340,641574,429016,3250,974466,648527,1255,130,0
537570,-424466,-112455,649,-1223112,-326149,-420,130,0
713076,-1039389,328262,1949,-1598277,504829,-839,130,0
-353614,156655,196957,-2,726451,903874,836,130,0
-64,-77,141,0,-8896,16311,0,124,1
620123,-1082941,467367,4549,-1628651,700686,-420,130,0
-24051,-926935,954885,3899,-1395089,1433840,-211,130,0
-189808,-164457,355563,1298,-753893,1631792,208,130,0
456967,529119,-988688,-2602,875595,-1631793,626,130,0
30000,30000,30000,90000,60000,60000,180000,124,1
-349064,131954,220358,3248,610612,1006516,208,130,0
-1041340,782629,261959,3248,1177864,391923,1464,130,0
-666275,-378315,1049139,4549,-584848,1613149,209,130,0
167056,185906,-350364,2598,866797,-1632002,627,130,0
511569,572671,-1083591,649,861351,-1632212,626,130,0
0,0,0,0,0,0,0,124,1
-1006238,179406,832681,5849,270638,1260187,1255,130,0
132604,-989988,860632,3248,-1503177,1306062,208,130,0
-427717,533019,-105304,-2,1542975,-305621,1255,130,0
776,-8935,8158,-1,-25528,23309,0,124,1
-42902,-95554,139755,1299,-1090725,1598067,-630,130,0
83853,-980237,898983,2599,-1472593,1349004,209,130,0
129354,-542121,412765,-2,-1563505,1192109,-630,130,0
-189808,-163807,354913,1298,-751589,1631582,-2,130,0
-872333,957485,-84504,648,1476572,-132178,1255,130,0
1026388,-824231,-200858,1299,-1239031,-302270,-211,130,0
-237456,151298,86157,-1,195798,111497,-1,124,1
-989988,436166,553170,-652,720167,910368,1256,130,0
-45922,69526,-23603,1,111242,-37765,1,124,1
-8440,8699,-259,0,24856,-740,0,124,1
30000,30000,30000,90000,60000,60000,180000,124,1
-20801,-110505,133254,1948,-1268986,1525170,-630,130,0
-479718,498568,-18851,-1,1442428,-56139,1255,130,0
999,366,-1366,-1,4227,-15777,-1,124,1
504,-29,-474,1,-854,-13698,1,124,1
1023138,-273661,-749479,-2,-422088,-1155452,-421,130,0
1144,147,-1291,0,1707,-14922,-1,124,1
884683,-58503,-826181,-1,-97824,-1362830,-1,130,0
8820,-8302,-518,0,-23721,-1480,0,124,1
-1058890,749478,310061,649,1126125,462096,1046,130,0
-27952,930834,-902884,-2,1435725,-1392365,1046,130,0
-60290,-1850,62141,1,-2961,99426,0,124,1
222115,-31380,-190735,0,-40610,-246833,0,124,1
985436,-568772,-417966,-1302,-938648,-688118,-211,130,0
222115,-190735,-31380,0,-246833,-40610,0,124,1
-292511,564221,-271061,649,1633677,-786361,1046,130,0
-929535,-20801,955535,5199,-34354,1431326,417,130,0
-46152,-913285,962686,3249,-1377702,1448922,-211,130,0
220358,341262,-562272,-652,987663,-1620062,627,130,0
-1015989,837231,180706,1948,1261025,269591,1465,130,0
0,0,0,0,0,0,0,124,1
-484919,-9751,495968,1298,-28698,1428813,627,130,0
-591523,-477768,1075140,5849,-727918,1630535,627,130,0
900933,-975687,76702,1948,-1468823,115000,-211,130,0
367,188,-556,-1,5452,-16060,0,124,1
-787180,-237909,1029638,4549,-364274,1561409,627,130,0
-214212,201630,12582,0,260933,16283,0,124,1
972436,-91654,-879483,1299,-140347,-1338950,208,130,0
-705927,-360114,1071890,5849,-544629,1605817,-211,130,0
1041989,-779380,-262610,-1,-1175142,-395275,-210,130,0
7150,301611,-306812,1949,1402000,-1426928,837,130,0
-705927,391964,315261,1298,905759,724775,1045,130,0
-4823,4971,-148,0,14354,-427,0,124,1
1008187,-178757,-826831,2599,-272524,-1258093,209,130,0
-912635,789779,122854,-2,1304176,200884,1465,130,0
-7000,-2562,9562,0,-7320,27320,0,124,1
-750779,1053039,-300962,1298,1586755,-455185,1255,130,0
1012087,-165757,-845682,648,-250530,-1272338,-2,130,0
-1066040,640273,429666,3899,974047,649365,1674,130,0
4301,1030,-5332,-1,2976,-15397,-1,124,1
-634424,1080340,-445267,649,1625508,-670942,1046,130,0
-8820,8302,518,0,23721,1480,0,124,1
-98804,135855,-36402,649,1579424,-427744,837,130,0
548620,-1086841,542770,4549,-1633887,813801,-420,130,0
258709,305511,-565522,-1302,884603,-1631164,628,130,0
-646,188,457,-1,357,866,0,124,1
180706,-354264,175506,1948,-1633887,806260,-629,130,0
-973087,96203,882733,5849,143698,1337692,1046,130,0
544720,-665625,122204,1299,-1533969,279646,-420,130,0
-124805,117654,9750,2599,1372046,82322,1046,130,0
141705,-52652,-87754,1299,-592599,-1021808,-420,130,0
-63003,59302,3700,-1,94884,5921,0,124,1
597372,26650,-624024,-2,63051,-1444524,418,130,0
-1014689,838531,179406,3248,1262910,266658,1255,130,0
-938636,-651,943835,4548,-3143,1416035,417,130,0
-676026,-393265,1075140,5849,-596579,1615243,626,130,0
-767029,1049139,-280161,1949,1578586,-424183,1046,130,0
-167707,1012087,-844382,-2,1524542,-1270662,1046,130,0
-759229,-169657,930834,1948,-281741,1534387,418,130,0
1017938,-771579,-244410,1949,-1187920,-377051,-420,130,0
73,-141,67,-1,-16328,7793,-1,124,1
-211258,-477768,692275,3249,-1105597,1593877,-630,130,0
-119605,-3251,125454,2598,-39381,1433631,418,130,0
139755,-99454,-38352,1949,-1128430,-458955,-630,130,0
284710,754028,-1038089,649,1147491,-1580053,1255,130,0
892483,92303,-980887,3899,136576,-1477621,627,130,0
-140406,70202,71502,1298,822599,810868,836,130,0
-1051090,766378,286010,1298,1152728,426486,1256,130,0
354913,-183957,-170307,649,-840614,-792855,-630,130,0
-634424,585671,48751,-2,1358220,107250,1255,130,0
-770279,-277561,1053039,5199,-418527,1576491,417,130,0
92003,146356,-238359,0,189402,-308465,0,124,1
-5587,2027,3559,-1,5853,10279,-1,124,1
770278,-1019239,251559,2598,-1568113,386896,-420,130,0
484268,9100,-496619,-3251,30792,-1429233,208,130,0
-297712,963986,-668226,-1952,1595343,-1102874,836,130,0
-537,420,117,0,12138,3396,0,124,1
-8820,8302,518,0,23721,1480,0,124,1
1073190,-687726,-384165,1299,-1034377,-578145,-630,130,0
522619,553170,-1073191,2598,839566,-1632840,836,130,0
44,466,-510,0,13461,-14742,0,124,1
1396,-889,-506,1,-10279,-5853,1,124,1
841131,159905,-999088,1948,241731,-1519096,837,130,0
0,0,0,0,0,0,0,124,1
524569,-78653,-446567,-651,-225812,-1287629,208,130,0
-1030939,260009,777429,6499,391713,1177655,836,130,0
1018588,-187858,-830082,648,-285721,-1249715,208,130,0
30000,30000,30000,90000,60000,60000,180000,124,1
-128055,540170,-412116,-1,1564132,-1190853,1046,130,0
109204,-133906,27301,2599,-1541719,302478,-420,130,0
45922,23603,-69526,-1,37765,-111242,-1,124,1
0,0,0,0,0,0,0,124,1
-9101,615573,-605823,649,1426508,-1402420,836,130,0
84503,-980237,898983,3249,-1473222,1347956,208,130,0
-2568,5649,-3080,1,16311,-8896,0,124,1
194500,-219631,25130,-1,-284228,32521,0,124,1
83853,-980237,898983,2599,-1472593,1349004,418,130,0
-504419,678625,-172257,1949,1573349,-404073,1256,130,0
141705,-90354,-49402,1949,-1031235,-581706,-630,130,0
-228649,49985,178664,0,64686,231212,-1,124,1
30000,30000,30000,90000,60000,60000,180000,124,1
-172257,-842432,1017938,3249,-1267939,1526008,208,130,0
254,404,-658,0,766,-1247,0,124,1
-1205,-37,1242,0,-427,14354,0,124,1
139755,-42252,-95554,1949,-469848,-1119841,-211,130,0
132,410,-542,0,11848,-15661,0,124,1
-632,493,138,-1,935,261,-1,124,1
167056,185906,-351664,1298,866169,-1632002,627,130,0
-43,-94,138,1,-10929,15977,1,124,1
-634424,586321,48101,-2,1358849,106621,1465,130,0
-106604,132604,-24701,1299,1542556,-304783,1255,130,0
331512,-563572,232708,648,-1625718,672197,-630,130,0
767678,-1053690,287960,1948,-1580262,431094,-1,130,0
-941236,739727,200207,-1302,1221854,328662,837,130,0
541,-1402,860,-1,-16194,9943,-1,124,1
494018,189807,-684476,-651,440521,-1582148,208,130,0
-934736,11700,928234,5198,14663,1407446,836,130,0
30000,30000,30000,90000,60000,60000,180000,124,1
120254,-663675,545370,1949,-1532293,1256626,-420,130,0
-128705,987386,-856083,2598,1504013,-1304387,1464,130,0
1306,-184,-1121,1,-2132,-12958,0,124,1
1036788,-767679,-267811,1298,-1165507,-408472,-211,130,0
-536921,421215,115704,-2,1220178,331595,1465,130,0
-44202,-588273,635073,2598,-1359269,1464423,-211,130,0
769628,280160,-1048490,1298,418526,-1576282,209,130,0
-705927,393264,314611,1948,909111,721423,1255,130,0
530419,528469,-1059540,-652,814220,-1632840,837,130,0
3788,-9814,6026,0,-28042,17218,-1,124,1
-1086191,472567,615573,1949,708855,920632,1255,130,0
0,122,-122,0,14145,-14145,0,124,1
-559671,206057,354263,649,594274,1020550,418,130,0
-56124,-174391,230515,0,-225683,298314,0,124,1
325662,-285361,-39652,649,-1311718,-187898,-839,130,0
-243760,341262,-96204,1298,1586127,-453299,1047,130,0
-457,-59,516,0,-1707,14922,1,124,1
1300,120904,-121555,649,1414987,-1414151,1045,130,0
247659,-344513,99453,2599,-1586128,453089,-840,130,0
-134,29,105,0,3396,12138,0,124,1
986086,-104654,-882084,-652,-160666,-1327219,208,130,0
-206708,1023788,-816431,649,1544861,-1232328,1466,130,0
88,439,-528,-1,12694,-15249,0,124,1
-292511,564221,-271061,649,1633468,-785523,1046,130,0
559020,-208658,-352964,-2602,-595112,-1019714,-421,130,0
-1042640,781329,265209,3898,1174094,397160,1256,130,0
470,172,-642,0,325,-1215,0,124,1
-288611,-31852,323062,2599,-143070,1480552,417,130,0
707876,-1071241,366613,3248,-1607075,549027,-211,130,0
4301,1030,-5332,-1,2976,-15397,-1,124,1
0,0,0,0,0,0,0,124,1
-297712,-750779,1054989,6498,-1134505,1585289,-2,130,0
-1320,-4103,5423,0,-11848,15661,0,124,1
1080990,-635724,-443317,1949,-957500,-667590,-420,130,0
-41562,70323,-28760,1,112517,-46016,1,124,1
132604,-113755,-16901,1948,-1298103,-209683,-2,130,0
64352,-642225,579821,1948,-1481810,1336435,-420,130,0
-969187,60452,913284,4549,88816,1368066,418,130,0
430,103,-533,0,2976,-15397,-1,124,1
132,410,-542,0,11848,-15661,0,124,1
312661,391314,-704627,-652,906178,-1629698,417,130,0
-254,-404,658,0,-766,1247,0,124,1
0,0,0,0,0,0,0,124,1
122204,2600,-122855,1949,40637,-1434260,-2,130,0
-143006,-838532,982836,1298,-1292447,1511554,417,130,0
537,69,-607,-1,131,-1149,0,124,1
-972437,116354,858032,1949,176794,1318002,1046,130,0
-1084241,619473,467367,2599,929220,699638,1255,130,0
1042639,-779380,-262610,649,-1175142,-395066,-211,130,0
430,103,-533,0,2976,-15397,-1,124,1
1074490,-391965,-680576,1949,-591132,-1023065,-210,130,0
-706577,-245710,954235,1948,-407844,1573768,417,130,0
768328,281460,-1049140,648,419783,-1576492,627,130,0
657824,-556421,-99454,1949,-1284696,-231468,-420,130,0
378964,689675,-1069291,-652,1038565,-1610845,418,130,0
-140406,60452,81253,1299,705504,922936,418,130,0
0,0,0,0,0,0,0,124,1
841131,159255,-998438,1948,240684,-1518887,837,130,0
566821,518719,-1085541,-1,778819,-1632421,1046,130,0
263909,434866,-698127,648,1008401,-1616501,627,130,0
347,-664,317,0,-1258,600,-1,124,1
482,14,-497,-1,427,-14354,0,124,1
0,0,0,0,0,0,0,124,1
131954,-19501,-110505,1948,-214710,-1294751,-1,130,0
-56124,230515,-174391,0,298314,-225683,0,124,1
482,14,-497,-1,427,-14354,0,124,1
84503,-142356,59802,1949,-1625509,670941,-630,130,0
-65328,56098,9229,-1,89757,14767,-1,124,1
-163807,-762479,927584,1298,-1260188,1530197,-2,130,0
800830,234008,-1032239,2599,349190,-1555964,417,130,0
114,14,-129,-1,1707,-14922,-1,124,1
345812,-107905,-237259,648,-489119,-1104969,-420,130,0
-1144,-147,1291,0,-1707,14922,1,124,1
140,-80,-60,0,-9251,-7032,0,124,1
30000,30000,30000,90000,60000,60000,180000,124,1
101403,35751,-135206,1948,420621,-1576701,418,130,0
-20801,-109855,133905,3249,-1264797,1527474,-421,130,0
-1748,5533,-3785,0,15977,-10929,1,124,1
-91004,-438767,529119,-652,-1265634,1527265,-1,130,0
7800,301611,-307462,1949,1400534,-1428185,837,130,0
213207,135855,-349064,-2,637215,-1620691,626,130,0
30000,30000,30000,90000,60000,60000,180000,124,1
169006,-1014038,848281,3249,-1523495,1272546,208,130,0
-113105,127404,-13651,648,1494797,-175748,1256,130,0
-2568,5649,-3080,1,16311,-8896,0,124,1
25350,926934,-951636,648,1395088,-1433422,1046,130,0
1000387,-195658,-803431,1298,-303107,-1238194,-211,130,0
918,472,-1390,0,5452,-16060,0,124,1
-1054340,705276,352313,3249,1071662,532479,1046,130,0
-98804,135205,-35752,649,1578376,-423764,1045,130,0
68756,-20082,-48674,0,-32132,-77878,1,124,1
0,0,0,0,0,0,0,124,1
-253510,563571,-309412,649,1631373,-897172,1256,130,0
-559671,206057,354263,649,594483,1020550,627,130,0
-240416,120208,120208,0,155563,155563,0,124,1
-65328,56098,9229,-1,89757,14767,-1,124,1
339962,724777,-1062790,1949,1088420,-1598696,627,130,0
734527,-1060190,329562,3899,-1596182,494983,-630,130,0
-635724,1079690,-444617,-651,1625508,-669685,1046,130,0
-1033539,807980,225558,-1,1216407,336622,1255,130,0
-8008,9043,-1034,1,25838,-2956,0,124,1
-91654,-47452,140405,1299,-542744,1605398,-1,130,0
-1042640,781329,265209,3898,1174303,396950,1255,130,0
-985437,105953,884683,5199,156266,1330151,836,130,0
319161,-26001,-291861,1299,-113954,-1354032,-211,130,0
-353614,182006,172256,648,843965,789293,837,130,0
256109,-565522,310711,1298,-1630955,897380,-421,130,0
-358814,-706577,1069940,4549,-1064541,1605189,-420,130,0
110504,880782,-988688,2598,1325124,-1489770,837,130,0
-659775,-399115,1066689,7799,-610194,1617548,418,130,0
103,516,-620,-1,978,-1175,-1,124,1
131304,-350364,221658,2598,-1616292,1015104,-211,130,0
219708,341262,-561622,-652,987663,-1620272,417,130,0
-598673,1080990,-481669,648,1630535,-726871,1046,130,0
434866,644824,-1077741,1949,968392,-1622995,627,130,0
8820,-8302,-518,0,-23721,-1480,0,124,1
-722178,-324363,1052389,5848,-494566,1595553,208,130,0
-518720,-552521,1077090,5849,-842290,1633258,418,130,0
-106604,132604,-25351,649,1542347,-303945,1465,130,0
419915,659774,-1077741,1948,989758,-1619853,208,130,0
-597373,1080990,-482969,648,1630535,-728756,1046,130,0
-205408,1023788,-817081,1299,1544651,-1232747,1256,130,0
976336,-78653,-897034,649,-120028,-1350471,208,130,0
87753,809280,-897034,-1,1337483,-1480763,837,130,0
-850882,-13651,865832,1299,-25137,1426718,418,130,0
92003,-238359,146356,0,-308465,189402,0,124,1
-42902,-94904,139755,1949,-1089258,1598695,-629,130,0
-260010,-304862,565521,649,-881671,1631792,418,130,0
382214,664974,-1047190,-2,1023483,-1613778,627,130,0
11061,54952,-66014,-1,87924,-105622,0,124,1
1051739,-764429,-285361,1949,-1150215,-429629,-420,130,0
-50000,-18301,68301,0,-29282,109282,0,124,1
432266,99453,-531720,-1,289700,-1536692,-2,130,0
-273661,-771579,1048489,3249,-1162364,1575025,-210,130,0
30000,30000,30000,90000,60000,60000,180000,124,1
-430,533,-103,0,15397,-2976,1,124,1
0,489,-489,0,14145,-14145,0,124,1
313311,390664,-703977,-2,905340,-1629698,836,130,0
-46802,-587623,636373,1948,-1355708,1466937,-211,130,0
54602,-141706,88403,1299,-1618805,1000232,-629,130,0
676675,-520020,-155356,1299,-1199441,-360712,-420,130,0
-542121,662374,-117655,2598,1533340,-277971,1256,130,0
504418,-33152,-473868,-2602,-92378,-1365972,-211,130,0
-1043290,354913,690975,2598,544628,1061607,836,130,0
137,-97,-40,0,-11243,-4639,0,124,1
733227,299011,-1028989,3249,457697,-1586337,417,130,0
1069940,-702027,-365314,2599,-1056790,-550495,-421,130,0
297711,-966587,670825,1949,-1594088,1106015,-212,130,0
102053,554470,-655875,648,1284695,-1515745,1255,130,0
-48102,951635,-903534,-1,1450388,-1375608,836,130,0
30000,30000,30000,90000,60000,60000,180000,124,1
399,-546,146,-1,-15777,4227,-1,124,1
99,-136,36,-1,-15777,4227,-1,124,1
-588273,-393915,984786,2598,-652508,1622994,-1,130,0
601272,-1082941,485568,3899,-1630745,730221,-1,130,0
43,94,-138,-1,10929,-15977,-1,124,1
-917835,918484,650,1299,1416454,-2724,1255,130,0
230758,-1035489,806680,1949,-1554916,1211171,-210,130,0
-137156,40301,99453,2598,470266,1119422,628,130,0
352963,-207358,-146256,-651,-946189,-680158,-421,130,0
22750,108554,-131305,-1,1267938,-1525590,627,130,0
-1260,1186,74,0,13698,854,-1,124,1
156137,80252,-236390,-1,103856,-305917,-1,124,1
167706,185256,-351014,1948,865331,-1632002,836,130,0
-118955,-3251,125454,3248,-38334,1433212,418,130,0
330,-1355,1025,0,-15661,11848,0,124,1
-936036,-3251,945785,6498,-8379,1418758,627,130,0
-526520,1071890,-544721,649,1633677,-829931,1046,130,0
43,-138,94,-1,-15977,10929,-1,124,1
343862,-248960,-93604,1298,-1145397,-436542,-840,130,0
-521970,1082290,-559671,649,1633677,-845013,1675,130,0
-1013388,167056,849581,3249,249691,1273384,1046,130,0
143005,-81254,-59153,2598,-928174,-699639,-1,130,0
-106604,-25351,135205,3250,-292215,1537738,207,130,0
-224259,347113,-122205,649,1611682,-573537,1045,130,0
-83,-57,140,0,-6643,16244,1,124,1
-5587,2027,3559,-1,5853,10279,-1,124,1
603222,-1074491,473867,2598,-1630117,718700,-2,130,0
-707877,346462,363363,1948,798509,834958,1046,130,0
-807331,-92954,901583,1298,-154801,1485580,417,130,0
-1078391,435516,645474,2599,653764,969649,628,130,0
-967887,911984,57202,1299,1372046,82532,1256,130,0
-204758,-809281,1018588,4549,-1231909,1545489,627,130,0
253509,-1041990,791729,3248,-1565180,1187919,-211,130,0
677325,-520020,-156006,1299,-1200070,-359875,-421,130,0
-212558,-138456,352963,1949,-638054,1620899,-420,130,0
-932135,9100,929534,6499,11102,1409122,627,130,0
-366614,1066039,-698127,1298,1608540,-1053020,1464,130,0
-564222,322412,241809,-1,931106,696915,627,130,0
919784,-919135,650,1299,-1414779,0,-420,130,0
-170957,-842432,1017938,4549,-1267520,1526217,-2,130,0
-60290,-1850,62141,1,-2961,99426,0,124,1
103,-620,516,-1,-1175,978,-1,124,1
1039388,-245710,-791730,1948,-371605,-1191481,-1,130,0
635073,-590873,-44202,-2,-1360316,-103689,-629,130,0
-1951,-940586,944485,1948,-1413313,1416244,-212,130,0
545370,-664975,120904,1299,-1532712,276503,-421,130,0
-11061,-54952,66014,1,-87924,105622,0,124,1
182813,43812,-226626,-1,56698,-293281,-1,124,1
-132605,988037,-855433,-1,1505061,-1302502,1046,130,0
-233773,68281,165491,-1,88364,214165,-1,124,1
-124805,6500,120254,1949,85883,1369532,627,130,0
91003,249609,-339963,649,1162782,-1574607,836,130,0
1052389,-648725,-402366,1298,-999185,-619411,-420,130,0
30000,30000,30000,90000,60000,60000,180000,124,1
-276261,-769629,1048489,2599,-1160270,1575863,-1,130,0
2955,2699,-5654,0,7793,-16328,-1,124,1
-349714,131954,220358,2598,613126,1004631,627,130,0
75402,65652,-139106,1948,777143,-1632212,836,130,0
30000,30000,30000,90000,60000,60000,180000,124,1
-1083591,620123,466067,2599,930477,697753,1046,130,0
-449167,1077740,-627274,1299,1626555,-946817,1046,130,0
99,-136,36,-1,-15777,4227,-1,124,1
-1032889,261959,776129,5199,394646,1175770,1046,130,0
-213859,1016638,-803431,-652,1549259,-1223321,1255,130,0
-127405,540170,-412116,649,1563923,-1191062,1046,130,0
27059,43045,-70105,-1,68873,-112169,-1,124,1
12350,-128055,118304,2599,-1471546,1349841,-2,130,0
706576,-1071241,367263,2598,-1607284,550703,-420,130,0
256,308,-564,0,8896,-16311,0,124,1
-1088141,547970,543420,3249,821970,811916,1255,130,0
-333463,265859,68902,1298,1233165,311695,1046,130,0
874932,-958136,85153,1949,-1475107,129873,-210,130,0
977636,-80604,-895734,1298,-122542,-1348795,418,130,0
-810581,1029638,-217759,1298,1551145,-330339,1465,130,0
-840482,-136506,982186,5198,-214082,1509460,627,130,0
-783930,-240510,1030288,5848,-368672,1562666,837,130,0
-1008188,825530,187857,5199,1254112,280483,1464,130,0
3788,-9814,6026,0,-28042,17218,-1,124,1
-1344,1050,294,0,12138,3396,0,124,1
843731,137155,-977637,3249,209472,-1506947,627,130,0
-131955,-863233,1000387,5199,-1302921,1504851,-212,130,0
228649,-49985,-178664,0,-64686,-231212,1,124,1
-1396,506,889,-1,5853,10279,-1,124,1
5500,-1606,-3893,1,-4639,-11243,0,124,1
-970487,60452,912634,2599,88606,1368066,417,130,0
776,8158,-8935,-1,23309,-25528,0,124,1
216,344,-560,0,9943,-16194,-1,124,1
917834,-921735,4550,649,-1417502,5655,-211,130,0
942535,-213859,-730628,-1952,-352962,-1204468,-211,130,0
235308,111154,-344513,1949,518235,-1600162,418,130,0
-277561,701376,-420566,3249,1622784,-976353,1464,130,0
-1076441,395864,682525,1948,593436,1021388,836,130,0
-522,73,448,-1,2132,12958,0,124,1
891833,77352,-964637,4548,115838,-1468195,836,130,0
-174,-378,553,1,-10929,15977,1,124,1
-7000,-2562,9562,0,-7320,27320,0,124,1
-874283,956185,-79953,1949,1474478,-127360,1255,130,0
-328913,51351,278860,1298,238798,1280087,836,130,0
599322,25350,-623374,1298,59490,-1443267,-210,130,0
0,0,0,0,0,0,0,124,1
290560,29901,-319162,1299,141813,-1479716,208,130,0
-396515,546670,-149506,649,1581099,-434028,1045,130,0
-765079,1049789,-283411,1299,1579633,-428163,1046,130,0
770278,-1053040,285360,2598,-1579215,426905,-211,130,0
-2310,-7180,9491,1,-20516,27119,1,124,1
30000,30000,30000,90000,60000,60000,180000,124,1
0,0,0,0,0,0,0,124,1
-32502,133905,-101404,-1,1566227,-1185406,628,130,0
-493369,-189808,687075,3898,-441150,1582356,-2,130,0
-939936,741027,198257,-652,1224158,325101,836,130,0
705926,-1071241,367913,2598,-1607913,551751,-630,130,0
-590223,-478418,1075140,6499,-729803,1630535,208,130,0
-70492,30441,40050,-1,48706,64081,-1,124,1
-124805,6500,120904,2599,86931,1368904,628,130,0
290560,29251,-319162,649,141394,-1479506,418,130,0
1069940,-700727,-369214,-1,-1053439,-554894,-840,130,0
0,0,0,0,0,0,0,124,1
237456,-151298,-86157,1,-195798,-111497,1,124,1
-917835,918484,650,1299,1416244,-2305,1255,130,0
700076,-440717,-258710,649,-1015315,-600768,-630,130,0
7000,2562,-9562,0,7320,-27320,0,124,1
570071,-1087491,521319,3899,-1633259,782589,-2,130,0
103353,553170,-656525,-2,1281763,-1517630,1046,130,0
43,-138,94,-1,-15977,10929,-1,124,1
-615574,1080340,-462168,2598,1628231,-697963,1256,130,0
668225,379614,-1045890,1949,582334,-1612312,418,130,0
-233359,-113105,348413,1949,-519912,1600790,-2,130,0
67602,-888584,821630,648,-1467357,1355497,-212,130,0
-98804,135855,-35102,1949,1578376,-423135,1465,130,0
646,-457,-188,1,-866,-357,0,124,1
86453,-527170,442016,1299,-1521191,1276317,-420,130,0
-362714,555770,-191758,1298,1608959,-557826,836,130,0
126,-7,-118,1,-854,-13698,1,124,1
53768,12885,-66654,-1,20617,-106647,0,124,1
4823,148,-4971,0,427,-14354,0,124,1
505,121,-626,0,229,-1186,0,124,1
-5500,3893,1606,-1,11243,4639,0,124,1
-890534,-51352,947085,5199,-81695,1453530,417,130,0
649374,321762,-971137,-1,529128,-1602467,417,130,0
90353,892483,-982187,649,1341672,-1477621,1046,130,0
-543421,661724,-117655,648,1532921,-276086,1255,130,0
-945786,215158,731277,649,352961,1205096,1046,130,0
-650025,83203,568771,1949,191667,1308785,627,130,0
234008,-1035489,804730,3249,-1556383,1208238,-421,130,0
5172,4723,-9896,-1,13496,-28274,0,124,1
-373114,1056289,-683826,-651,1610844,-1041499,1255,130,0
-10401,-117655,129354,1298,-1344396,1475525,-211,130,0
-177457,-376365,554470,648,-1085278,1599742,-1,130,0
978936,-877533,-99454,1949,-1332247,-152497,-2,130,0
107,25,-133,-1,2976,-15397,-1,124,1
37701,-954886,922384,5199,-1440335,1387756,-2,130,0
367,188,-556,-1,5452,-16060,0,124,1
409515,294461,-702027,1949,681624,-1625718,837,130,0
-454368,516769,-63053,-652,1498358,-184755,837,130,0
-489469,1082940,-593473,-2,1631582,-893192,1255,130,0
-2568,5649,-3080,1,16311,-8896,0,124,1
9750,850881,-861283,-652,1407237,-1422111,626,130,0
736477,-1059540,326312,3249,-1594716,490166,-210,130,0
963986,-289261,-674726,-1,-479065,-1112719,-211,130,0
215808,812530,-1027039,1299,1223111,-1549051,627,130,0
-140406,78652,62402,648,926497,702361,1255,130,0
-3059,-6624,9683,0,-18925,27666,1,124,1
-1045890,358163,687725,-2,550075,1056789,627,130,0
-5226,738,4487,-1,2132,12958,0,124,1
-957486,874282,84503,1299,1347118,127778,1465,130,0
672125,-1074491,406265,3899,-1617549,610403,-211,130,0
30000,30000,30000,90000,60000,60000,180000,124,1
522,-73,-448,1,-2132,-12958,0,124,1
-9145,1292,7853,0,3691,22439,-1,124,1
219058,809280,-1028339,-1,1220597,-1550308,1046,130,0
897683,-964637,68902,1948,-1463377,102851,-1,130,0
-222959,944485,-722828,-1302,1563085,-1193157,1046,130,0
711126,358813,-1067340,2599,536878,-1604142,418,130,0
1018588,-770279,-246360,1949,-1185825,-380193,-629,130,0
1018588,-185907,-832032,649,-281741,-1252228,208,130,0
-1043940,354263,690975,1298,544838,1061398,837,130,0
-204758,-807981,1019238,6499,-1231490,1545489,418,130,0
0,0,0,0,0,0,0,124,1
1035488,-769629,-265210,649,-1168230,-404492,-2,130,0
-344513,106603,240509,2599,494983,1100778,1045,130,0
2955,2699,-5654,0,7793,-16328,-1,124,1
999,366,-1366,-1,4227,-15777,-1,124,1
0,0,0,0,0,0,0,124,1
918,-1390,472,0,-16060,5452,0,124,1
-313312,-391965,707226,1949,-908484,1629697,-2,130,0
1003637,-142356,-861283,-2,-214919,-1294542,208,130,0
-219059,-807981,1030938,3898,-1219969,1550935,-1,130,0
-24051,928884,-904834,-1,1433421,-1395089,1045,130,0
2164,3443,-5608,-1,9943,-16194,-1,124,1
-223609,347763,-122205,1949,1611682,-572699,1045,130,0
-2568,5649,-3080,1,16311,-8896,0,124,1
-60290,-1850,62141,1,-2961,99426,0,124,1
219058,341912,-561622,-652,988711,-1620062,209,130,0
721527,343212,-1062790,1949,513627,-1599324,418,130,0
1748,3785,-5533,0,10929,-15977,-1,124,1
-289911,-30552,322412,1949,-139300,1478877,418,130,0
549270,-1086841,542120,4549,-1633887,812544,-420,130,0
-637674,1079690,-441367,649,1624879,-665076,1046,130,0
127404,-9101,-117005,1298,-88607,-1367857,-1,130,0
57206,-64597,7391,0,-103355,11826,0,124,1
-139106,50051,90353,1298,589246,1024740,627,130,0
-3901,-938636,945785,3248,-1411009,1418549,-211,130,0
-1062790,331512,733877,2599,496869,1099103,628,130,0
30000,30000,30000,90000,60000,60000,180000,124,1
735177,-1060190,326962,1949,-1595135,491632,-211,130,0
-392615,1071240,-677976,649,1615034,-1021389,837,130,0
295,-565,269,-1,-16328,7793,-1,124,1
880782,113104,-991938,1948,167368,-1490399,626,130,0
-333463,265859,69552,1948,1232118,312952,837,130,0
1396,-889,-506,1,-10279,-5853,1,124,1
30000,30000,30000,90000,60000,60000,180000,124,1
8008,-9043,1034,-1,-25838,2956,0,124,1
-11061,66014,-54952,1,105622,-87924,0,124,1
-1016639,771578,247009,1948,1187919,378098,1674,130,0
5500,-1606,-3893,1,-4639,-11243,0,124,1
-1003638,865182,139105,649,1301244,205492,1255,130,0
-205,650,-444,1,1231,-842,1,124,1
0,0,0,0,0,0,0,124,1
67249,-52548,-14701,0,-84077,-23522,0,124,1
30000,30000,30000,90000,60000,60000,180000,124,1
22100,-317862,296411,649,-1460863,1363667,-1,130,0
30000,30000,30000,90000,60000,60000,180000,124,1
143005,-72803,-68903,1299,-819877,-813173,-211,130,0
9414,-2058,-7356,0,-5880,-21019,0,124,1
-74753,334762,-258710,1299,1557848,-1204887,1046,130,0
-550,160,389,-1,4639,11243,0,124,1
840481,161856,-999088,3249,244035,-1520144,836,130,0
1084240,-487519,-595423,1298,-735669,-894868,-2,130,0
636373,-589573,-45502,1298,-1357384,-108507,-421,130,0
-533670,-547971,1086190,4549,-827627,1633677,418,130,0
-1027039,278210,749478,649,427114,1152099,1045,130,0
-352964,157305,196307,648,729383,900942,418,130,0
43,94,-138,-1,10929,-15977,-1,124,1
259359,784579,-1042640,1298,1179540,-1567904,1255,130,0
9625,-2811,-6814,0,-8033,-19469,0,124,1
452416,-1080341,631173,3248,-1626137,949120,-2,130,0
-1070591,702026,370513,1948,1054485,553845,1255,130,0
44851,93603,-135856,2598,1089048,-1598487,626,130,0
-102704,342562,-239209,649,1592411,-1112300,1046,130,0
-541,1402,-860,1,16194,-9943,1,124,1
-897034,975036,-75403,2599,1470079,-117724,1046,130,0
705276,246359,-953586,-1951,405329,-1572721,208,130,0
915234,-135856,-781330,-1952,-225393,-1287839,-2,130,0
-939286,919784,22100,2598,1400115,29745,1675,130,0
5547,58274,-63822,-1,93239,-102115,0,124,1
-1409,608,801,0,7032,9251,0,124,1
-514170,-568772,1086840,3898,-857372,1632630,418,130,0
41562,-70323,28760,-1,-112517,46016,-1,124,1
449166,-1080341,633773,2598,-1625718,953310,208,130,0
-1205,1242,-37,0,14354,-427,0,124,1
141313,97786,-239099,0,126546,-309422,-1,124,1
-488819,1083590,-593473,1298,1631373,-893820,1256,130,0
289260,29901,-319812,-651,143488,-1480344,627,130,0
-228649,49985,178664,0,64686,231212,-1,124,1
273660,55902,-329563,-1,268334,-1529151,418,130,0
-211258,558370,-347114,-2,1618176,-1004422,836,130,0
-850232,-13001,865832,2599,-24928,1426718,417,130,0
0,0,0,0,0,0,0,124,1
703326,-295762,-406916,648,-683300,-943256,-420,130,0
-87754,-893784,984136,2598,-1343349,1476572,-2,130,0
812530,-1032889,222308,1949,-1552193,333689,-630,130,0
30000,30000,30000,90000,60000,60000,180000,124,1
430316,-535621,105953,648,-1542557,304782,-630,130,0
563,-320,-243,0,-9251,-7032,0,124,1
1051089,-648725,-401716,648,-999395,-619202,-421,130,0
-91,-47,139,1,-5452,16060,0,124,1
538220,-423166,-115055,-1,-1218922,-332643,-630,130,0
8820,-8302,-518,0,-23721,-1480,0,124,1
1033538,-811231,-222309,-2,-1217875,-334319,-630,130,0
-114,-14,129,1,-1707,14922,1,124,1
735827,-1060840,326962,1949,-1595135,492051,208,130,0
1076440,-412766,-663675,-1,-622134,-996881,-420,130,0
-598023,1081640,-482969,648,1630744,-728337,1464,130,0
-458918,-529120,989337,1299,-874758,1632001,208,130,0
-453717,517419,-63053,649,1498148,-184336,1046,130,0
-731928,1058239,-325663,648,1595134,-491214,1255,130,0
375714,-1069291,697476,3899,-1609379,1048829,-2,130,0
-1015989,837231,181356,2598,1260397,270429,1465,130,0
8450,301611,-307462,2599,1398649,-1430071,1046,130,0
-367,556,-188,1,16060,-5452,0,124,1
-1065390,421865,648724,5199,638891,982845,1255,130,0
-724778,-335413,1065389,5198,-507343,1598276,208,130,0
-798880,-232709,1036788,5199,-352753,1557638,626,130,0
-347,-317,664,0,-600,1258,1,124,1
1306,-184,-1121,1,-2132,-12958,0,124,1
103,-620,516,-1,-1175,978,-1,124,1
-74753,334762,-258710,1299,1557638,-1205097,1045,130,0
1069940,-702677,-365314,1949,-1057000,-550076,-212,130,0
5379,-4203,-1176,0,-12138,-3396,0,124,1
-557721,357513,200857,649,1035423,577097,1046,130,0
1051089,-763129,-286011,1949,-1148539,-432143,-839,130,0
1077090,-651975,-423166,1949,-984103,-637426,-630,130,0
732577,298361,-1029639,1299,458745,-1586547,417,130,0
1059539,-330213,-729978,-652,-497708,-1098266,-212,130,0
-534321,-547321,1086190,4548,-826789,1633468,209,130,0
-328263,704626,-375065,1298,1632839,-869103,1464,130,0
482968,-499869,17550,649,-1439706,51530,-210,130,0
-110505,-879483,992587,2599,-1324496,1490398,-1,130,0
-919135,139755,780029,649,230001,1285533,627,130,0
-3673,-1888,5562,1,-5452,16060,0,124,1
891183,76052,-964637,2598,114372,-1467566,1046,130,0
89053,892483,-981537,-1,1343348,-1476364,1046,130,0
794329,-1039389,246359,1299,-1563714,371185,-420,130,0
-123505,993237,-869083,649,1498777,-1311509,627,130,0
785879,258709,-1041340,3248,385429,-1566856,417,130,0
0,0,0,0,0,0,0,124,1
330,-1355,1025,0,-15661,11848,0,124,1
88,-528,439,-1,-15249,12694,0,124,1
-850232,-14301,866482,1949,-25766,1427346,626,130,0
447216,622073,-1068641,648,946397,-1625509,1255,130,0
694226,-960086,266509,649,-1582567,440521,-420,130,0
208657,-1025089,819680,3248,-1544443,1233584,417,130,0
-289261,-31202,322412,1949,-141814,1479924,417,130,0
-234009,-112455,348413,1949,-516770,1599952,-2,130,0
-409516,-294462,705926,1948,-681415,1626136,-1,130,0
-674726,-395865,1075140,4549,-599721,1615872,417,130,0
-154056,351663,-195658,1949,1629697,-914558,837,130,0
45501,-139756,96853,2598,-1596811,1097636,-631,130,0
707876,-346463,-360114,1299,-798510,-834749,-420,130,0
-3788,-6026,9814,0,-17218,28042,1,124,1
30000,30000,30000,90000,60000,60000,180000,124,1
48751,584371,-633124,-2,1356545,-1466309,837,130,0
54602,-141056,88403,1949,-1618805,1000441,-420,130,0
562921,-323713,-241160,-1952,-931944,-696078,-629,130,0
48751,462817,-510920,648,1341253,-1477830,837,130,0
-505719,35101,472567,1949,99918,1361991,418,130,0
457617,-519370,63052,1299,-1497730,183707,-630,130,0
30000,30000,30000,90000,60000,60000,180000,124,1
1039388,-247660,-790430,1298,-373490,-1190224,-1,130,0
-194500,219631,-25130,1,284228,-32521,0,124,1
-469318,1080340,-611023,-1,1629069,-921680,1047,130,0
-939286,919134,22750,2598,1398649,32258,1674,130,0
848931,-1010788,163156,1299,-1521610,245083,-420,130,0
-992588,504418,487518,-652,831606,802489,1255,130,0
62402,269110,-330213,1299,1252646,-1533969,1046,130,0
537,-607,69,-1,-1149,131,0,124,1
-21451,-110505,133905,1949,-1266263,1526846,-211,130,0
-215159,-810581,1029638,3898,-1223321,1549469,-1,130,0
-252860,563571,-312012,-1301,1631373,-899476,1256,130,0
-531720,-549271,1086840,5849,-830141,1633468,418,130,0
50701,912634,-962037,1298,1375607,-1450599,1046,130,0
-642875,1050439,-406266,1298,1620480,-628000,1464,130,0
-937336,-1951,944485,5198,-5656,1417501,836,130,0
369863,183306,-555771,-2602,534574,-1603514,208,130,0
5547,58274,-63822,-1,93239,-102115,0,124,1
826830,197607,-1023789,648,294099,-1538158,627,130,0
-98804,-37052,138455,2599,-421460,1576910,-211,130,0
-36946,-33740,70686,0,-53984,113098,1,124,1
-934736,33801,904183,3248,49435,1389222,627,130,0
638973,-1082941,447216,3248,-1625718,670312,-630,130,0
891833,89053,-980237,649,132177,-1475526,418,130,0
-1748,-3785,5533,0,-10929,15977,1,124,1
-145606,918484,-774830,-1952,1519724,-1278831,1046,130,0
646,-457,-188,1,-866,-357,0,124,1
-7151,-852832,861282,1299,-1408495,1421062,-211,130,0
102053,35101,-133906,3248,418526,-1576282,-1,130,0
-882084,-106604,993237,4549,-162342,1488931,1045,130,0
30000,30000,30000,90000,60000,60000,180000,124,1
-50000,-18301,68301,0,-29282,109282,0,124,1
300311,751428,-1052390,-651,1131990,-1585709,627,130,0
458267,529769,-988038,-2,875386,-1631583,837,130,0
2568,3080,-5649,-1,8896,-16311,0,124,1
75402,65002,-139106,1298,774839,-1632212,627,130,0
-353614,180706,172906,-2,840404,793063,1046,130,0
-127405,986736,-856733,2598,1503176,-1305434,1675,130,0
-403016,-142356,546020,648,-409101,1573977,207,130,0
-48752,326312,-276911,649,1515953,-1285534,1465,130,0
-566,-17,584,1,-32,1106,1,124,1
-140,80,60,0,9251,7032,0,124,1
-1015989,837231,181356,2598,1260397,270429,1465,130,0
1074490,-393265,-679926,1299,-592389,-1021808,-1,130,0
-488819,1082940,-594773,-652,1631373,-894658,1256,130,0
-11,-116,127,0,-13461,14742,0,124,1
-888584,64352,825530,1298,104736,1359477,836,130,0
884,4396,-5281,-1,12694,-15249,0,124,1
325012,-286011,-37702,1299,-1315070,-182032,-630,130,0
419915,659774,-1077091,2598,989967,-1619853,207,130,0
-341263,-722828,1066689,2598,-1088002,1599114,-421,130,0
-806681,-92304,901583,2598,-153544,1484951,208,130,0
12350,-128055,118304,2599,-1474269,1346490,-211,130,0
0,0,0,0,0,0,0,124,1
-563,320,243,0,9251,7032,0,124,1
139105,-41602,-96204,1299,-464401,-1123821,-210,130,0
367,188,-556,-1,5452,-16060,0,124,1
813830,-1031589,220358,2599,-1551146,330757,-421,130,0
579171,-643525,66952,2598,-1484533,151658,-420,130,0
-46802,-587623,636373,1948,-1355708,1467146,-421,130,0
192407,160556,-351014,1949,752006,-1631374,836,130,0
-878183,835281,42901,-1,1379796,68078,1046,130,0
235308,111154,-344513,1949,517188,-1599953,418,130,0
550,-389,-160,1,-11243,-4639,0,124,1
214212,-201630,-12582,0,-260933,-16283,0,124,1
104653,-345163,243109,2599,-1591365,1116070,-840,130,0
810580,-1033539,224258,1299,-1553031,336832,-211,130,0
397814,-548621,150805,-2,-1580891,433608,-421,130,0
11700,115054,-126105,649,1346071,-1474269,837,130,0
-136506,-407566,544070,-2,-1177865,1569159,-211,130,0
1073190,-499219,-574622,-651,-758501,-873292,208,130,0
-4301,-1030,5332,1,-2976,15397,1,124,1
731927,298361,-1028989,1299,457697,-1586337,208,130,0
-1015339,837231,181356,3248,1260606,270010,1255,130,0
-1074491,687075,389364,1948,1031443,581705,1046,130,0
352963,-1043290,692925,2598,-1605609,1064959,-630,130,0
-91,-47,139,1,-5452,16060,0,124,1
277560,770278,-1046540,1298,1159640,-1575864,1255,130,0
-155,-482,637,0,-912,1206,1,124,1
-90354,137805,-46152,1299,1607283,-549447,1255,130,0
1306,-1121,-184,1,-12958,-2132,0,124,1
1006887,-146256,-858033,2598,-221623,-1290562,-212,130,0
-894434,-87104,983486,1948,-132387,1476154,628,130,0
-20151,315261,-293161,1949,1461700,-1362411,836,130,0
-5818,-4026,9845,1,-11504,28129,0,124,1
457,-516,59,0,-14922,1707,-1,124,1
911984,-791730,-119605,649,-1306272,-196486,-630,130,0
-3059,9683,-6624,0,27666,-18925,1,124,1
1073190,-684476,-388065,649,-1029559,-583801,-421,130,0
402365,141055,-545371,-1951,412032,-1574397,417,130,0
300311,265209,-565522,-2,768974,-1632002,627,130,0
755328,-1056290,302261,1299,-1586756,455603,-629,130,0
624023,-1083591,463467,3899,-1627813,694820,-212,130,0
-239675,103501,136173,-1,133943,176224,0,124,1
305511,2600,-306162,1949,17176,-1422948,-1,130,0
140,-60,-80,0,-7032,-9251,0,124,1
-576572,641574,-63703,1299,1484951,-152078,836,130,0
0,0,0,0,0,0,0,124,1
30000,30000,30000,90000,60000,60000,180000,124,1
5639,-2435,-3204,0,-7032,-9251,0,124,1
70710,-35355,-35355,0,-56568,-56568,1,124,1
221,-1320,1099,0,-15249,12694,0,124,1
109204,24700,-131305,2599,295565,-1538368,626,130,0
156655,517419,-674076,-2,1199231,-1559944,1046,130,0
-566822,287310,280810,1298,827836,806050,1046,130,0
-140406,59802,80603,-1,709483,919585,836,130,0
-700727,438116,264559,1948,1012800,603700,1046,130,0
-27059,70105,-43045,1,112169,-68873,1,124,1
-967237,913284,54602,649,1374140,78761,1255,130,0
1024438,-275611,-748179,648,-426068,-1152310,-211,130,0
-125617,240333,-114716,0,311020,-148456,1,124,1
797579,-908735,113104,1948,-1498568,186011,-421,130,0
-643525,-435517,1082940,3898,-656069,1623622,627,130,0
-171607,-842432,1017938,3899,-1267101,1526427,208,130,0
-8008,-1034,9043,1,-2956,25838,0,124,1
30000,30000,30000,90000,60000,60000,180000,124,1
371813,-1068641,700726,3898,-1608332,1053438,-420,130,0
8440,-8699,259,0,-24856,740,0,124,1
1051089,-647425,-402366,1298,-998347,-620878,-630,130,0
566,17,-584,-1,32,-1106,-1,124,1
-52002,138455,-85154,1299,1618595,-1000023,837,130,0
532369,135205,-668876,-1302,315465,-1545071,627,130,0
-274311,-770279,1048489,3899,-1161527,1575234,-2,130,0
724127,338662,-1061490,1299,507552,-1597858,418,130,0
-22,-109,132,1,-12694,15249,0,124,1
33,-135,102,0,-15661,11848,0,124,1
-110,-1165,1276,1,-13461,14742,0,124,1
-420566,700726,-278211,1949,1623203,-647900,1255,130,0
-112455,128054,-13001,2598,1494587,-175329,1046,130,0
114,-129,14,-1,-14922,1707,-1,124,1
-317862,24050,295111,1299,113743,1354240,836,130,0
-107,-25,133,1,-2976,15397,1,124,1
690975,-481669,-208658,648,-1108739,-484720,-629,130,0
30000,30000,30000,90000,60000,60000,180000,124,1
-521320,-550571,1077090,5199,-840195,1633468,209,130,0
-447867,1077740,-629224,649,1626345,-949540,1046,130,0
594122,480367,-1071891,2598,728964,-1629907,836,130,0
-273661,-770929,1048489,3899,-1161945,1575234,-1,130,0
-651975,-319162,972436,1299,-528710,1602884,207,130,0
-1074491,687725,388714,1948,1032281,580658,1046,130,0
505,-626,121,0,-1186,229,0,124,1
-4301,-1030,5332,1,-2976,15397,1,124,1
-482969,-11701,497268,2598,-35192,1431955,627,130,0
878832,-835932,-43552,-652,-1377912,-70593,-211,130,0
-189158,-163807,354913,1948,-754312,1631582,-2,130,0
738,-1413,674,-1,-16328,7793,-1,124,1
30000,30000,30000,90000,60000,60000,180000,124,1
30000,30000,30000,90000,60000,60000,180000,124,1
347,317,-664,0,600,-1258,-1,124,1
948385,-16251,-928885,3249,-27651,-1400116,208,130,0
690325,-481669,-209308,-652,-1108949,-484301,-420,130,0
-550,389,160,-1,11243,4639,0,124,1
0,0,0,0,0,0,0,124,1
-490769,1083590,-592823,-2,1631582,-892354,1046,130,0
978286,-876233,-102054,-1,-1330362,-155639,207,130,0
301,362,-663,0,685,-1256,0,124,1
-689026,481668,209957,2599,1112928,479692,1255,130,0
300961,-315262,16900,2599,-1449342,71639,-630,130,0
-878183,993237,-113755,1299,1493959,-173863,1046,130,0
143005,-72153,-68903,1949,-821343,-811917,-211,130,0
-275611,-769629,1048489,3249,-1160270,1575863,-420,130,0
137,-97,-40,0,-11243,-4639,0,124,1
437,946,-1383,0,10929,-15977,-1,124,1
-37609,224447,-186838,0,290462,-241791,1,124,1
1041339,-353614,-687726,-1,-546096,-1059932,-211,130,0
458267,-519370,62402,1299,-1496264,179937,-211,130,0
-141313,-97786,239099,0,-126546,309422,1,124,1
234658,111154,-344513,1299,518444,-1600162,208,130,0
579821,-643525,65002,1298,-1483696,149354,-420,130,0
-191108,-828782,1023138,3248,-1248248,1536691,208,130,0
140,-60,-80,0,-7032,-9251,0,124,1
3673,1888,-5562,-1,5452,-16060,0,124,1
432916,97503,-531070,-651,284254,-1534807,-2,130,0
-820981,991937,-167707,3249,1527893,-261841,1255,130,0
-794330,908084,-113755,-1,1500243,-189154,1046,130,0
43,94,-138,-1,10929,-15977,-1,124,1
0,0,0,0,0,0,0,124,1
-109146,-130940,240086,0,-169451,310700,1,124,1
65002,-143006,78652,648,-1631374,895286,-630,130,0
-230109,1032238,-801481,648,1556591,-1207820,1046,130,0
232708,-1034839,805380,3249,-1555754,1209914,-420,130,0
-276911,-768979,1049789,3899,-1158594,1576281,-421,130,0
55252,85153,-139106,1299,991643,-1619224,1046,130,0
-114,-14,129,1,-1707,14922,1,124,1
657824,-557721,-98154,1949,-1285953,-229583,-421,130,0
551220,-164457,-388065,-1302,-470476,-1119423,-421,130,0
1017938,-837232,-178107,2599,-1261026,-268544,-1,130,0
5379,-1176,-4203,0,-3396,-12138,0,124,1
-730628,-299012,1033538,3898,-462935,1587802,-2,130,0
-1144,-147,1291,0,-1707,14922,1,124,1
867782,-1002988,137155,1949,-1506109,204864,-211,130,0
570721,-1088791,520669,2599,-1633469,781542,-212,130,0
-2601,-489469,492068,-2,-1410590,1418967,-212,130,0
90353,249609,-339963,-1,1162992,-1574607,627,130,0
-53768,66654,-12885,1,106647,-20617,0,124,1
-1375,973,401,-1,11243,4639,0,124,1
-50000,-18301,68301,0,-29282,109282,0,124,1
30000,30000,30000,90000,60000,60000,180000,124,1
298361,-966587,670175,1949,-1594716,1104968,-630,130,0
694876,-960086,265859,649,-1582357,439264,-629,130,0
393914,-1073841,683175,3248,-1613988,1025997,-211,130,0
-427066,1053039,-625324,649,1624460,-964832,1674,130,0
655874,420565,-1076441,-2,632188,-1620062,627,130,0
-627274,29901,599972,2599,65774,1380425,418,130,0
-437,1383,-946,0,15977,-10929,1,124,1
410165,293811,-702677,1299,679738,-1625509,836,130,0
85153,810580,-896384,-651,1339158,-1479506,627,130,0
256,308,-564,0,8896,-16311,0,124,1
-566,584,-17,1,1106,-32,1,124,1
-692276,957485,-266510,-1301,1582775,-439684,1045,130,0
564871,-247010,-318512,-651,-709903,-918957,-210,130,0
157305,518069,-674726,648,1199231,-1559944,836,130,0
52,-599,547,0,-1136,1037,-1,124,1
-881434,-109205,994537,3898,-165693,1489979,418,130,0
-759879,-170957,931484,648,-284255,1535434,627,130,0
300311,-315912,17550,1949,-1450599,74781,-211,130,0
381564,688375,-1068641,1298,1036889,-1611055,627,130,0
-9868,4261,5607,0,12176,16020,-1,124,1
531719,136505,-668226,-2,316722,-1545490,836,130,0
709176,359463,-1067340,1299,537716,-1604352,208,130,0
369863,689025,-1057590,1298,1047991,-1608541,627,130,0
-136506,96203,40951,648,1126963,461049,1046,130,0
30000,30000,30000,90000,60000,60000,180000,124,1
1039388,-247660,-791080,648,-373281,-1190224,208,130,0
640273,-1082941,445916,3248,-1625299,667798,-211,130,0
1084240,-616874,-466068,1298,-927755,-700268,-2,130,0
1144,-1291,147,0,-14922,1707,-1,124,1
-228649,49985,178664,0,64686,231212,-1,124,1
102053,35101,-134556,2598,418107,-1576073,208,130,0
-39652,956835,-918485,-1302,1443266,-1384615,627,130,0
33,102,-135,0,11848,-15661,0,124,1
549920,-392615,-157956,-651,-1130106,-456651,-840,130,0
-362714,555770,-191758,1298,1608959,-557407,837,130,0
-228159,1031588,-804081,-652,1555334,-1210753,1045,130,0
0,0,0,0,0,0,0,124,1
1082940,-489469,-593473,-2,-737344,-893402,-2,130,0
32101,38511,-70613,-1,61618,-112982,-1,124,1
148205,-1004938,859982,3249,-1511555,1292237,-210,130,0
-33,135,-102,0,15661,-11848,0,124,1
-130005,-865183,999737,4549,-1304596,1503804,-1,130,0
-808631,1030288,-222309,-652,1553239,-336833,1254,130,0
-5172,9896,-4723,1,28274,-13496,0,124,1
769628,281460,-1049140,1948,419992,-1576701,208,130,0
6429,-9733,3304,0,-27810,9441,0,124,1
390,270,-661,-1,511,-1251,-1,124,1
-989338,826830,163806,1298,1274222,249063,1465,130,0
35751,909384,-947086,-1951,1386290,-1440963,837,130,0
136505,-106604,-26651,3250,-1218713,-333062,-630,130,0
-74292,-160869,235162,1,-208184,304328,1,124,1
-558371,357513,200857,-1,1034166,578354,837,130,0
949685,-18851,-926935,3899,-32678,-1397602,418,130,0
182813,43812,-226626,-1,56698,-293281,-1,124,1
-70710,35355,35355,0,56568,56568,-1,124,1
-956836,875582,81903,649,1349423,123588,1465,130,0
-566172,-83854,651974,1948,-194391,1501709,627,130,0
0,0,0,0,0,0,0,124,1
-563,320,243,0,9251,7032,0,124,1
-676026,-391965,1074490,6499,-594903,1615034,208,130,0
-452417,-241810,698776,4549,-561387,1608959,208,130,0
-445917,-620774,1072540,5849,-946189,1626555,417,130,0
57206,-64597,7391,0,-103355,11826,0,124,1
1344,-294,-1050,0,-3396,-12138,0,124,1
-776,-8158,8935,1,-23309,25528,0,124,1
866482,-1003638,139105,1949,-1507366,208006,-420,130,0
111154,-967887,859982,3249,-1491656,1322820,-2,130,0
676025,-520670,-154706,649,-1201745,-357570,-420,130,0
704626,-1071891,369213,1948,-1608122,553636,-629,130,0
-128705,111804,19500,2599,1299149,209053,1674,130,0
291210,-1050440,762478,3248,-1581519,1146025,-629,130,0
-596073,1080990,-484269,648,1630744,-731060,1255,130,0
831,-1406,575,0,-16244,6643,-1,124,1
192407,160556,-351664,1299,752006,-1631374,626,130,0
313311,656524,-969187,648,1082764,-1600372,208,130,0
581121,-1060190,481668,2599,-1631793,741114,-840,130,0
-443,-4661,5105,1,-13461,14742,0,124,1
237456,-86157,-151298,1,-111497,-195798,1,124,1
-565522,247009,319161,648,713045,916443,837,130,0
532369,135205,-668226,-652,316094,-1545071,1046,130,0
417315,-1079041,664974,3248,-1619643,996671,-210,130,0
332,-562,230,0,-16244,6643,-1,124,1
-1080341,633773,448516,1948,953938,671988,1255,130,0
353613,-1042640,692925,3898,-1605399,1064749,-630,130,0
1037438,-712427,-323713,1298,-1097637,-499383,-1048,130,0
-559021,206057,354263,1299,594692,1020131,207,130,0
-848932,-16251,867782,2599,-29955,1429232,418,130,0
-85154,525219,-441367,-1302,1522238,-1274432,837,130,0
101403,-137156,38351,2598,-1579215,426486,-630,130,0
-233359,-112455,348413,2599,-518236,1600161,-421,130,0
-211258,1015988,-804081,649,1548422,-1225625,1046,130,0
962686,-288611,-676026,-1951,-476551,-1114605,-421,130,0
-879483,833331,46151,-1,1376863,73524,1045,130,0
121554,-126105,6500,1949,-1439497,50273,-1049,130,0
447216,622073,-1068641,648,947026,-1625509,836,130,0
-363364,555770,-191758,648,1609169,-557198,1256,130,0
0,0,0,0,0,0,0,124,1
431,221,-653,-1,420,-1237,0,124,1
50051,-328913,282110,3248,-1513441,1289304,-840,130,0
-1018589,769628,250259,1298,1184986,381868,1255,130,0
21450,-317212,297711,1949,-1460654,1364086,-421,130,0
650,-122855,124804,2599,-1411427,1417711,-210,130,0
-1951,-489469,492068,648,-1411218,1418339,-2,130,0
5587,-3559,-2027,1,-10279,-5853,1,124,1
9100,-616224,610372,3248,-1423367,1405980,-420,130,0
-7000,-2562,9562,0,-7320,27320,0,124,1
-194358,-826181,1024438,3899,-1244478,1538576,-2,130,0
926934,-958136,33151,1949,-1438449,48178,-630,130,0
-458918,-618824,1082290,4548,-934249,1627602,207,130,0
-53768,-12885,66654,1,-20617,106647,0,124,1
-52,599,-547,0,1136,-1037,1,124,1
-729328,-300312,1033538,3898,-465030,1588221,-212,130,0
571371,514169,-1086191,-651,772535,-1632421,208,130,0
-135856,-407566,544070,648,-1178494,1568740,-212,130,0
-365314,-689676,1060839,5849,-1051344,1608540,208,130,0
-169657,550570,-382215,-1302,1595134,-1102665,1046,130,0
468017,-694877,230108,3248,-1603095,528709,-211,130,0
46801,586321,-631824,1298,1359477,-1464005,1255,130,0
-783280,-257410,1045239,4549,-388991,1568322,418,130,0
-204108,1022488,-818381,-1,1543813,-1234842,1046,130,0
431,221,-653,-1,420,-1237,0,124,1
56124,-230515,174391,0,-298314,225683,0,124,1
-213208,558370,-345813,-651,1618804,-1000023,627,130,0
0,0,0,0,0,0,0,124,1
87103,809280,-897034,-651,1337692,-1480553,837,130,0
-42252,136505,-94254,-1,1596600,-1098266,836,130,0
30000,30000,30000,90000,60000,60000,180000,124,1
-25351,-926285,954885,3249,-1394460,1434259,-211,130,0
-6429,-3304,9733,0,-9441,27810,0,124,1
-226859,1030938,-804081,-2,1554915,-1211591,836,130,0
521319,465417,-988038,-1302,768974,-1632002,627,130,0
45922,-69526,23603,-1,-111242,37765,-1,124,1
506368,-682526,177456,1298,-1573978,407005,-630,130,0
991287,-824881,-165107,1299,-1270452,-254300,-420,130,0
-431617,-100754,533019,648,-291377,1537529,208,130,0
-99,136,-36,1,15777,-4227,1,124,1
-879483,-110505,994537,4549,-167369,1490817,837,130,0
482,-497,14,-1,-14354,427,0,124,1
30000,30000,30000,90000,60000,60000,180000,124,1
998437,-192408,-805381,648,-298499,-1241126,208,130,0
943185,-212558,-731278,-651,-352334,-1204887,-420,130,0
30000,30000,30000,90000,60000,60000,180000,124,1
-9414,7356,2058,0,21019,5880,0,124,1
30000,30000,30000,90000,60000,60000,180000,124,1
-871683,957485,-85804,-2,1477829,-134901,1255,130,0
140,-80,-60,0,-9251,-7032,0,124,1
132604,-20151,-110505,1948,-219737,-1291400,-2,130,0
69840,-25340,-44499,1,-40544,-71199,1,124,1
116354,-130005,16900,3249,-1493750,173862,-420,130,0
936035,5850,-942536,-651,7959,-1417921,627,130,0
50701,-328913,281460,3248,-1514279,1288047,-421,130,0
137,-97,-40,0,-11243,-4639,0,124,1
970486,-913935,-55253,1298,-1371418,-83580,-630,130,0
141,-70,-70,1,-8167,-8167,0,124,1
-244410,341912,-96204,1298,1586127,-453090,1256,130,0
-3673,5562,-1888,1,16060,-5452,0,124,1
558370,-358814,-200208,-652,-1034377,-577726,-630,130,0
172256,-553821,381564,-1,-1595763,1100988,-1048,130,0
56124,-230515,174391,0,-298314,225683,0,124,1
493368,190457,-684476,-651,442825,-1582776,-1,130,0
-352314,204107,149505,1298,947863,678482,1046,130,0
-389365,-593473,983486,648,-979704,1621737,-1,130,0
43,-138,94,-1,-15977,10929,-1,124,1
986086,-568122,-418616,-652,-937600,-689794,-630,130,0
30000,30000,30000,90000,60000,60000,180000,124,1
710476,359463,-1067340,2599,537716,-1604352,208,130,0
136505,-107255,-27952,1298,-1214942,-338299,-420,130,0
867132,-1003638,138455,1949,-1506947,206749,-420,130,0
109146,130940,-240086,0,169451,-310700,-1,124,1
710476,-1040039,331512,1949,-1599115,509018,-630,130,0
130654,866482,-996488,648,1305433,-1502758,1045,130,0
1306,-184,-1121,1,-2132,-12958,0,124,1
826830,-991938,167706,2598,-1525381,255766,-420,130,0
-370514,-185257,556420,649,-535622,1604351,418,130,0
-31852,-102704,137805,3249,-1180798,1567903,-420,130,0
-642,-770,1412,0,-8896,16311,0,124,1
662,-286,-376,0,-541,-712,1,124,1
30000,30000,30000,90000,60000,60000,180000,124,1
8440,259,-8699,0,740,-24856,0,124,1
-670826,139105,533019,1298,320074,1227090,627,130,0
5226,-4487,-738,1,-12958,-2132,0,124,1
0,0,0,0,0,0,0,124,1
-614274,1080340,-464118,1948,1628650,-700687,1465,130,0
580471,-1060190,482318,2599,-1632002,741952,-1048,130,0
-618824,1080340,-459568,1948,1628021,-693984,1045,130,0
57206,7391,-64597,0,11826,-103355,0,124,1
139105,-98804,-38352,1949,-1128639,-458327,-420,130,0
69840,-25340,-44499,1,-40544,-71199,1,124,1
689025,-1073841,388064,3248,-1613150,581915,-630,130,0
-570072,-516120,1089440,3248,-777982,1632630,-211,130,0
-109146,-130940,240086,0,-169451,310700,1,124,1
512869,572671,-1084241,1299,860932,-1632212,1045,130,0
-529770,-528470,1062789,4549,-817363,1633258,-2,130,0
785229,258059,-1040689,2599,384591,-1566647,626,130,0
-227509,1032238,-803431,1298,1555334,-1210334,1045,130,0
-132,-410,542,0,-11848,15661,0,124,1
957485,-926285,-30552,648,-1391109,-46713,-630,130,0
-975037,96853,882083,3899,145164,1336854,1046,130,0
566,17,-584,-1,32,-1106,-1,124,1
-156137,236390,-80252,1,305917,-103856,1,124,1
1054339,-342563,-711127,649,-521378,-1079623,208,130,0
301611,729977,-1030289,1299,1123611,-1588222,837,130,0
-537,607,-69,1,1149,-131,0,124,1
-746878,934735,-187858,-1,1545070,-311905,1046,130,0
-1043940,356213,689675,1948,546933,1059722,837,130,0
544720,-664325,122204,2599,-1533760,279227,-421,130,0
254809,-564872,312011,1948,-1630536,901989,-1,130,0
-117655,661724,-542771,1298,1532711,-1255999,836,130,0
252209,-1041990,793029,3248,-1564971,1188757,-420,130,0
-98804,-36402,138455,3249,-420412,1576910,418,130,0
-831,-575,1406,0,-6643,16244,1,124,1
-3673,-1888,5562,1,-5452,16060,0,124,1
-933435,11050,927584,5199,13825,1407865,836,130,0
-72803,-67603,143655,3249,-775468,1632420,-1,130,0
-724128,-338663,1066039,3248,-511323,1599114,208,130,0
-44,-466,510,0,-13461,14742,0,124,1
157305,-353614,198907,2598,-1629907,911834,-211,130,0
0,-61237,61237,0,-97979,97979,0,124,1
-221009,944485,-724128,-652,1562247,-1194833,836,130,0
1080990,-634424,-445917,649,-954568,-670523,-2,130,0
-352964,180706,172906,648,842289,791178,836,130,0
30000,30000,30000,90000,60000,60000,180000,124,1
156137,-236390,80252,-1,-305917,103856,-1,124,1
-237456,151298,86157,-1,195798,111497,-1,124,1
44,-510,466,0,-14742,13461,0,124,1
-576572,1057589,-479718,1299,1631792,-741115,1674,130,0
0,0,0,0,0,0,0,124,1
671475,-141056,-528470,1949,-323426,-1224578,-1,130,0
5172,-9896,4723,-1,-28274,13496,0,124,1
541,860,-1402,-1,9943,-16194,-1,124,1
1034188,-230759,-803431,-2,-348144,-1207611,-2,130,0
255459,-565522,310711,648,-1630955,897590,-211,130,0
83203,-979587,899633,3249,-1471756,1350260,-212,130,0
-3673,5562,-1888,1,16060,-5452,0,124,1
-140406,60452,81253,1299,706551,922517,1046,130,0
884,4396,-5281,-1,12694,-15249,0,124,1
-37609,224447,-186838,0,290462,-241791,1,124,1
1077740,-651975,-424466,1299,-983265,-638264,-420,130,0
-1000,1366,-366,0,15777,-4227,0,124,1
-941886,936035,8450,2599,1410379,9635,1255,130,0
-297062,313311,-13001,3248,1449341,-71431,1046,130,0
-759879,-169657,931484,1948,-282579,1534596,208,130,0
-9414,7356,2058,0,21019,5880,0,124,1
-8440,8699,-259,0,24856,-740,0,124,1
916534,-136506,-781330,-1302,-226022,-1287420,207,130,0
450466,-1079691,632473,3248,-1625927,951843,208,130,0
120,3,-124,-1,427,-14354,0,124,1
454367,533019,-988688,-1302,880413,-1631374,627,130,0
156137,-236390,80252,-1,-305917,103856,-1,124,1
30000,30000,30000,90000,60000,60000,180000,124,1
-969837,112454,859982,2599,171139,1321144,627,130,0
2310,-9491,7180,-1,-27119,20516,-1,124,1
214508,812530,-1027039,-1,1224158,-1548423,836,130,0
-90354,138455,-46152,1949,1607283,-550076,1045,130,0
256109,83203,-338013,1299,391923,-1568741,418,130,0
-3673,-1888,5562,1,-5452,16060,0,124,1
-3325,-2300,5625,0,-6643,16244,1,124,1
1396,-889,-506,1,-10279,-5853,1,124,1
969836,-59803,-908735,1298,-92168,-1365762,418,130,0
78652,-338663,262609,2598,-1558687,1202373,-420,130,0
-99454,135855,-35752,649,1578586,-424183,1046,130,0
30000,30000,30000,90000,60000,60000,180000,124,1
586971,498568,-1082941,2598,749074,-1631164,837,130,0
336062,-267811,-66303,1948,-1231281,-314210,-421,130,0
-133906,29901,107254,3249,345629,1209914,627,130,0
-56124,-174391,230515,0,-225683,298314,0,124,1
-549271,391314,158605,648,1131152,455393,627,130,0
343862,-249610,-92954,1298,-1145188,-436542,-631,130,0
1077090,-653925,-421216,1949,-986407,-634703,-630,130,0
841781,174856,-1014038,2599,261631,-1526637,837,130,0
142355,-80604,-59153,2598,-926289,-702153,-630,130,0
122204,2600,-122855,1949,39799,-1433841,-2,130,0
161206,764428,-926285,-651,1262282,-1528942,836,130,0
1038088,-711777,-324363,1948,-1096799,-500012,-839,130,0
-369864,1066039,-695527,648,1609169,-1049668,1046,130,0
-962037,688375,272360,-1302,1137017,447643,837,130,0
-831,-575,1406,0,-6643,16244,1,124,1
-333463,1060839,-726728,648,1597857,-1094286,1255,130,0
-839182,-174207,1018588,5199,-264355,1527893,417,130,0
85803,809280,-897034,-1951,1338949,-1479716,1046,130,0
33801,101403,-134556,648,1185196,-1565809,836,130,0
482,-497,14,-1,-14354,427,0,124,1
-457,516,-59,0,14922,-1707,1,124,1
-142356,-838532,982836,1948,-1292238,1511764,208,130,0
1074490,-571372,-502469,649,-868265,-764157,-211,130,0
390,-661,270,-1,-1251,511,-1,124,1
361413,344512,-706577,-652,798090,-1632840,417,130,0
196307,826830,-1021189,1948,1244896,-1538158,1047,130,0
226858,-349714,125454,2598,-1611683,572698,-629,130,0
65328,-56098,-9229,1,-89757,-14767,1,124,1
2600,120904,-121555,1949,1413312,-1415826,837,130,0
157955,518069,-673426,2598,1199650,-1559734,837,130,0
474517,-1083591,613622,4548,-1629070,921470,-211,130,0
1080990,-634424,-445267,1299,-955824,-669685,-630,130,0
0,0,0,0,0,0,0,124,1
-831,1406,-575,0,16244,-6643,1,124,1
-20151,-928885,952935,3899,-1398021,1430698,-420,130,0
-676676,-391315,1074490,6499,-594065,1614824,208,130,0
128054,-9751,-117005,1298,-90702,-1366810,-2,130,0
0,0,0,0,0,0,0,124,1
1065389,-352314,-711127,1948,-533737,-1069987,-211,130,0
-169657,549920,-380915,-652,1595343,-1102455,417,130,0
564221,-323713,-241160,-652,-932363,-695450,-420,130,0
407565,295111,-702677,-1,684347,-1626137,418,130,0
747528,-938636,190457,-651,-1545909,315046,-630,130,0
16507,51291,-67798,0,82066,-108478,-1,124,1
22,109,-132,-1,12694,-15249,0,124,1
-1396,889,506,-1,10279,5853,-1,124,1
1063439,-718277,-343213,1949,-1082974,-517608,-211,130,0
1320,4103,-5423,0,11848,-15661,0,124,1
-1042640,781979,263909,3248,1175560,394856,1046,130,0
52,-599,547,0,-1136,1037,-1,124,1
1077740,-432917,-643525,1298,-653974,-969440,-211,130,0
-298362,963986,-668226,-2602,1595762,-1102455,1255,130,0
66952,75402,-139106,3248,883346,-1631164,627,130,0
-469,642,-172,1,1215,-325,1,124,1
831,575,-1406,0,6643,-16244,-1,124,1
85153,-142356,59802,2599,-1625718,670731,-839,130,0
222115,-190735,-31380,0,-246833,-40610,0,124,1
-27302,930834,-902884,648,1435725,-1392365,837,130,0
636373,-590223,-44202,1948,-1358850,-106203,-630,130,0
16507,51291,-67798,0,82066,-108478,-1,124,1
-238559,-711127,952285,2599,-1175142,1570207,-1,130,0
0,0,0,0,0,0,0,124,1
846981,19500,-866483,-2,31001,-1429442,-2,130,0
102703,553820,-656525,-2,1282391,-1517211,836,130,0
912634,-791080,-120255,1299,-1305644,-197743,-630,130,0
107254,882083,-988038,1299,1327218,-1488094,1465,130,0
155,-637,482,0,-1206,912,-1,124,1
748178,-937986,190457,649,-1545699,315046,-211,130,0
0,489,-489,0,14145,-14145,0,124,1
-575922,642224,-64353,1949,1485789,-153753,1256,130,0
1041339,-356214,-686426,-1301,-549238,-1057209,-211,130,0
535620,548620,-1083591,649,825531,-1632840,1255,130,0
-1072541,496618,579821,3898,753682,878737,1255,130,0
-1205,-37,1242,0,-427,14354,0,124,1
70852,-889884,820330,1298,-1469032,1353403,-420,130,0
30000,30000,30000,90000,60000,60000,180000,124,1
100,36,-136,0,4227,-15777,0,124,1
-878833,833331,46151,649,1376654,73943,1046,130,0
-546021,1084240,-536271,1948,1633886,-809193,1046,130,0
50000,18301,-68301,0,29282,-109282,0,124,1
-126755,539520,-413416,-651,1562875,-1193995,836,130,0
1050439,-765729,-282761,1949,-1152310,-426696,-420,130,0
6999,-9562,2562,-1,-27320,7320,-1,124,1
588272,495968,-1082941,1299,745303,-1630955,836,130,0
-1069941,701376,370513,1948,1054485,553845,1255,130,0
-572022,-514820,1088790,1948,-775259,1632630,208,130,0
-52,599,-547,0,1136,-1037,1,124,1
776,-8935,8158,-1,-25528,23309,0,124,1
523919,-78003,-446567,-651,-224765,-1288258,207,130,0
47451,462817,-510920,-652,1342300,-1477411,836,130,0
-551221,163156,388714,649,470475,1119631,836,130,0
30000,30000,30000,90000,60000,60000,180000,124,1
697476,-245060,-451117,1299,-566205,-1043593,-420,130,0
63003,-59302,-3700,1,-94884,-5921,0,124,1
-63703,-76703,143655,3249,-884185,1631163,-421,130,0
122854,860632,-984137,-651,1311508,-1498778,1255,130,0
30000,30000,30000,90000,60000,60000,180000,124,1
30000,30000,30000,90000,60000,60000,180000,124,1
-314612,-655225,970486,649,-1082555,1600580,208,130,0
335412,-267811,-66303,1298,-1232119,-313372,-840,130,0
624673,-1083591,462817,3899,-1627813,694401,-2,130,0
-892484,-87104,984136,4548,-133644,1476572,417,130,0
0,-61237,61237,0,-97979,97979,0,124,1
917184,-137156,-780030,-2,-228745,-1285953,-211,130,0
142355,-62403,-77353,2599,-708018,-921052,-630,130,0
-3999,5464,-1464,1,15777,-4227,1,124,1
211907,477767,-688376,1298,1106853,-1593459,836,130,0
0,0,0,0,0,0,0,124,1
443,4661,-5105,-1,13461,-14742,0,124,1
-563572,323062,241809,1299,932572,695868,1256,130,0
-1017289,769628,250909,3248,1184777,382287,1255,130,0
110,-1276,1165,-1,-14742,13461,0,124,1
995837,-876233,-118955,649,-1316536,-179519,-211,130,0
-5587,2027,3559,-1,5853,10279,-1,124,1
-785230,-255460,1044589,3899,-385221,1567065,418,130,0
-697477,247009,453066,2598,569765,1040450,-2,130,0
-1053690,341262,716976,4548,515721,1084649,836,130,0
-85154,525219,-441367,-1302,1522656,-1273804,836,130,0
-771579,-275611,1051739,4549,-415594,1575653,418,130,0
-634424,586321,48101,-2,1359477,105364,1255,130,0
136505,-106604,-27952,1949,-1214314,-339137,-421,130,0
769628,-1053040,286010,2598,-1579634,428581,-1,130,0
1078390,-429667,-645475,3248,-649575,-973001,-211,130,0
960085,-924335,-33152,2598,-1388804,-51112,-630,130,0
1034188,-229459,-804081,648,-347097,-1208448,-1,130,0
515469,569421,-1084241,649,856324,-1632212,836,130,0
0,0,0,0,0,0,0,124,1
0,-61237,61237,0,-97979,97979,0,124,1
132,410,-542,0,11848,-15661,0,124,1
169999,-232224,62224,-1,-300525,80525,-1,124,1
-245060,341912,-96204,648,1585708,-451205,1255,130,0
417315,-1079041,663674,1948,-1619643,995623,-211,130,0
-988688,436816,553170,1298,720167,910158,1046,130,0
131954,-989338,861282,3898,-1502967,1306271,-2,130,0
-887934,62402,826830,1298,101803,1361153,836,130,0
734527,-1060190,329562,3899,-1595973,494565,-420,130,0
1064739,-351014,-711777,1948,-531223,-1072291,-420,130,0
70710,-35355,-35355,0,-56568,-56568,1,124,1
70710,-35355,-35355,0,-56568,-56568,1,124,1
275610,770928,-1046540,-2,1160688,-1575445,836,130,0
64,-141,77,0,-16311,8896,0,124,1
0,-575,575,0,-1090,1090,0,124,1
841781,-874283,34451,1949,-1442429,56767,-629,130,0
639623,-1083591,447216,3248,-1625509,669474,-421,130,0
9414,-7356,-2058,0,-21019,-5880,0,124,1
0,-61237,61237,0,-97979,97979,0,124,1
0,0,0,0,0,0,0,124,1
-70492,30441,40050,-1,48706,64081,-1,124,1
-98804,-36402,138455,3249,-420831,1576910,208,130,0
-174,553,-378,1,15977,-10929,1,124,1
-332,-230,562,0,-6643,16244,1,124,1
1084890,-469968,-613623,1299,-707599,-921052,-1,130,0
-228809,1032238,-802131,1298,1555963,-1209077,1256,130,0
521969,-451767,-69553,649,-1304387,-199418,-420,130,0
30000,30000,30000,90000,60000,60000,180000,124,1
139105,-99454,-38352,1299,-1130106,-456651,-421,130,0
-790430,1036788,-245060,1298,1563923,-371605,1256,130,0
399,-546,146,-1,-15777,4227,-1,124,1
-1041340,252859,791079,2598,378517,1187081,1046,130,0
669525,-137806,-531070,649,-316933,-1228977,-421,130,0
-44,-466,510,0,-13461,14742,0,124,1
-541,-860,1402,1,-9943,16194,1,124,1
-281461,325012,-40952,2599,1503594,-197324,1255,130,0
56552,886633,-944486,-1301,1368904,-1456045,1047,130,0
353613,-208008,-145606,-1,-949750,-676178,-420,130,0
-840482,873632,-34452,-1302,1443476,-58024,1256,130,0
120254,862582,-982837,-1,1314650,-1496473,1046,130,0
146255,-921085,776129,1299,-1519306,1279459,-211,130,0
997787,-191758,-806031,-2,-297033,-1241964,208,130,0
37051,286010,-320463,2598,1328056,-1487466,1255,130,0
-532370,-135206,671475,3899,-314628,1545280,209,130,0
-429017,1053039,-622724,1298,1624670,-961480,837,130,0
-656,418,238,0,792,451,0,124,1
0,0,0,0,0,0,0,124,1
-740378,-313962,1058889,4549,-474247,1590945,627,130,0
-371164,-184607,556420,649,-534156,1603932,208,130,0
-83,-57,140,0,-6643,16244,1,124,1
-1084241,491418,595422,2599,737972,893401,1256,130,0
-993888,877532,117654,1298,1320096,174071,1464,130,0
-523920,1081640,-557721,-1,1633468,-842081,837,130,0
105953,-345813,242459,2599,-1592412,1111881,-630,130,0
878182,-835932,-42902,-652,-1378540,-69755,-630,130,0
30000,30000,30000,90000,60000,60000,180000,124,1
306161,1950,-306162,1949,14453,-1421482,-1,130,0
397814,-548621,151455,648,-1581310,435493,-421,130,0
-1066040,358163,711126,3249,535621,1068729,1046,130,0
346462,-109205,-236609,648,-494984,-1100570,-629,130,0
635723,-589573,-45502,648,-1358012,-107251,-212,130,0
-134,105,29,0,12138,3396,0,124,1
-31202,-103354,137155,2599,-1184359,1566227,-630,130,0
-549921,163156,388714,1949,470685,1119422,837,130,0
-988688,436816,553170,1298,719538,910577,836,130,0
-1320,5423,-4103,0,15661,-11848,0,124,1
926934,29251,-954236,1949,40847,-1434260,208,130,0
-892484,-50052,946435,3899,-79810,1453112,836,130,0
4494,5391,-9885,0,15404,-28245,-1,124,1
558,-202,-355,1,-5853,-10279,1,124,1
-332,-230,562,0,-6643,16244,1,124,1
968536,-112455,-855433,648,-175329,-1318422,-2,130,0
-137,97,40,0,11243,4639,0,124,1
167706,185256,-351014,1948,862608,-1632212,417,130,0
-9868,5607,4261,0,16020,12176,-1,124,1
-617524,1080340,-462168,648,1628440,-697545,1464,130,0
-211908,-478418,692275,1949,-1105178,1594087,-420,130,0
-649375,83203,569421,3249,190829,1309204,627,130,0
-59803,967886,-908085,-2,1458139,-1366810,1046,130,0
-1017289,771578,247009,1298,1188129,377469,1255,130,0
566171,-287311,-278861,-1,-827627,-806051,-839,130,0
-379615,-687076,1071890,5199,-1036890,1611473,-1,130,0
-776,8935,-8158,1,25528,-23309,0,124,1
-137,40,97,0,4639,11243,0,124,1
-376365,705276,-326963,1948,1632839,-758920,1674,130,0
1061489,-331513,-728678,1298,-499174,-1097428,-421,130,0
976336,-629874,-347114,-652,-1038985,-572280,-630,130,0
986086,-432267,-554471,-652,-715769,-913511,-211,130,0
-68756,20082,48674,0,32132,77878,-1,124,1
-1344,294,1050,0,3396,12138,0,124,1
575921,-987387,412115,649,-1626556,680157,-630,130,0
-564222,323712,240509,-1,935295,692726,1046,130,0
262609,435516,-698777,-652,1009658,-1616501,208,130,0
-177457,351663,-172907,1299,1633886,-804795,1045,130,0
978936,-877533,-100104,1299,-1332037,-153125,-1,130,0
121554,-125455,6500,2599,-1438240,47969,-630,130,0
233773,-68281,-165491,1,-88364,-214165,1,124,1
-9868,4261,5607,0,12176,16020,-1,124,1
-11,127,-116,0,14742,-13461,0,124,1
-69840,25340,44499,-1,40544,71199,-1,124,1
-32101,-38511,70613,1,-61618,112982,1,124,1
848931,-998438,152105,2598,-1515326,228953,-2,130,0
9899,-4949,-4949,1,-14142,-14142,0,124,1
1067339,-639624,-427717,-2,-972163,-650832,-420,130,0
-35752,-910685,950985,4548,-1385662,1442638,418,130,0
1000387,-195658,-803431,1298,-303317,-1237984,-1,130,0
-344513,105303,241159,1949,490166,1104549,837,130,0
695526,-959436,265209,1299,-1582148,439054,-212,130,0
147555,-1004288,860632,3899,-1511136,1293074,-1,130,0
-5379,4203,1176,0,12138,3396,0,124,1
42901,-509620,468017,1298,-1471337,1350470,-630,130,0
22750,109204,-130655,1299,1267938,-1525590,837,130,0
-444617,-623374,1072540,4549,-949331,1626136,417,130,0
-945786,214508,731927,649,352333,1205305,836,130,0
-831,-575,1406,0,-6643,16244,1,124,1
156137,-236390,80252,-1,-305917,103856,-1,124,1
592172,480367,-1071891,648,730012,-1630117,627,130,0
-347114,225558,122204,648,1051762,556778,837,130,0
-155,637,-482,0,1206,-912,1,124,1
11061,54952,-66014,-1,87924,-105622,0,124,1
-222115,190735,31380,0,246833,40610,0,124,1
-118955,122854,-1951,1948,1438029,-46922,1255,130,0
-88404,-252860,342562,1298,-1163412,1574606,-211,130,0
-1066690,420565,649374,3249,637634,983893,1046,130,0
-633774,587622,47451,1299,1360106,104317,1465,130,0
927584,-957486,33151,3249,-1438240,47759,-421,130,0
107254,-966587,861282,1949,-1490189,1325333,-420,130,0
0,0,0,0,0,0,0,124,1
1344,-294,-1050,0,-3396,-12138,0,124,1
460217,55252,-515470,-1,161503,-1487885,417,130,0
-219709,-786530,1010787,4548,-1213266,1553868,-211,130,0
947085,-934736,-8451,3898,-1407657,-14245,-2,130,0
605822,476467,-1080341,1948,716396,-1629070,626,130,0
-276261,-768979,1049139,3899,-1159013,1576491,-211,130,0
-182813,226626,-43812,1,293281,-56698,1,124,1
139105,-40952,-96204,1949,-464820,-1123612,-211,130,0
-656,238,418,0,451,792,0,124,1
-657825,554470,104003,648,1282391,235447,1046,130,0
-5040,296,4744,0,854,13698,-1,124,1
141705,-90354,-50052,1299,-1030816,-582335,-631,130,0
-131955,987386,-855433,-2,1504642,-1302921,1255,130,0
-280811,324362,-41602,1949,1504223,-199209,1046,130,0
-573322,983486,-411466,-1302,1626764,-680368,836,130,0
5818,-9845,4026,-1,-28129,11504,0,124,1
-256,-308,564,0,-8896,16311,0,124,1
1017288,-772229,-241810,3249,-1189805,-374328,-420,130,0
330212,-707227,380264,3249,-1632421,874967,-630,130,0
136505,-31202,-103354,1949,-347306,-1208239,-211,130,0
-748179,934735,-186557,-1,1544442,-310020,1046,130,0
-330,-1025,1355,0,-11848,15661,0,124,1
1085540,-564222,-520670,648,-849831,-783219,-211,130,0
-213208,559020,-345813,-1,1618804,-1000861,1045,130,0
690325,-1073191,386764,3898,-1612731,579820,-630,130,0
-731278,-297712,1032888,3898,-460631,1587384,208,130,0
214508,135205,-349064,649,635330,-1620481,417,130,0
-41562,-28760,70323,1,-46016,112517,1,124,1
2310,7180,-9491,-1,20516,-27119,-1,124,1
568771,517419,-1085541,649,776515,-1632212,417,130,0
1075140,-412116,-663675,-651,-621506,-997300,-211,130,0
30000,30000,30000,90000,60000,60000,180000,124,1
2310,-9491,7180,-1,-27119,20516,-1,124,1
735177,-1049790,317861,3248,-1592621,480739,-1,130,0
128704,-542121,414065,648,-1562457,1193994,-211,130,0
30000,30000,30000,90000,60000,60000,180000,124,1
798229,-908735,112454,1948,-1498778,186430,-421,130,0
926934,26650,-952936,648,37705,-1432794,208,130,0
969836,-913935,-53953,1948,-1372047,-82323,-630,130,0
131954,-20151,-110505,1298,-220575,-1290981,-2,130,0
-659775,-416666,1079040,2599,-628419,1619642,207,130,0
-328913,51351,278860,1298,238798,1279878,417,130,0
635723,-590873,-44202,648,-1360107,-104318,-840,130,0
1035488,-809931,-224259,1298,-1216199,-336623,-420,130,0
-667576,1060189,-391315,1298,1615872,-598254,1256,130,0
-489469,1082940,-593473,-2,1631373,-893820,1256,130,0
55902,85153,-139106,1949,988501,-1620062,418,130,0
-430,-103,533,0,-2976,15397,1,124,1
521969,464117,-989338,-3252,767507,-1632002,627,130,0
957485,-876883,-78653,1949,-1349424,-122961,-630,130,0
141313,-239099,97786,0,-309422,126546,-1,124,1
0,0,0,0,0,0,0,124,1
-5379,1176,4203,0,3396,12138,0,124,1
-544721,1083590,-538221,648,1633886,-811288,1255,130,0
-539521,119604,419265,-652,346677,1209285,836,130,0
-1040039,249609,793029,2599,374327,1190223,1255,130,0
-783930,-258710,1045239,2599,-390667,1568950,418,130,0
785879,258059,-1040689,3249,384801,-1566856,208,130,0
312011,657824,-969187,648,1085068,-1599743,418,130,0
975036,-93604,-878833,2599,-144118,-1336436,417,130,0
30000,30000,30000,90000,60000,60000,180000,124,1
-550,389,160,-1,11243,4639,0,124,1
-304862,-726078,1033538,2598,-1121308,1589269,-630,130,0
-254,-404,658,0,-766,1247,0,124,1
206707,807330,-1014689,-652,1230861,-1545071,1674,130,0
223608,783929,-1008838,-1301,1209914,-1555126,1046,130,0
-918,-472,1390,0,-5452,16060,0,124,1
1260,-74,-1186,0,-854,-13698,1,124,1
707226,361413,-1067991,648,541905,-1605190,207,130,0
-225559,691625,-464768,1298,1602466,-1076690,1256,130,0
-982187,887933,97503,3249,1337902,143907,1674,130,0
727377,323062,-1048490,1949,489956,-1593878,418,130,0
-3999,5464,-1464,1,15777,-4227,1,124,1
797579,-909385,113104,1298,-1498987,187478,-210,130,0
-659125,-401716,1067339,6498,-613965,1617757,-2,130,0
366613,691625,-1056290,1948,1052390,-1607703,836,130,0
1082940,-620124,-462168,648,-932992,-694821,-211,130,0
-5656,2828,2828,0,8167,8167,0,124,1
34451,101403,-134556,1298,1183311,-1566437,1256,130,0
-73,141,-67,1,16328,-7793,1,124,1
397814,-548621,151455,648,-1581100,434865,-210,130,0
5040,-296,-4744,0,-854,-13698,1,124,1
8820,-8302,-518,0,-23721,-1480,0,124,1
155,-637,482,0,-1206,912,-1,124,1
-9868,4261,5607,0,12176,16020,-1,124,1
206707,-1024439,821630,3898,-1543395,1235888,-211,130,0
0,0,0,0,0,0,0,124,1
-459568,-55903,516769,1298,-163180,1489350,836,130,0
-221009,-787180,1010787,2598,-1213476,1553658,-212,130,0
68756,-48674,-20082,0,-77878,-32132,1,124,1
-577222,1057589,-479068,1299,1631792,-740486,1675,130,0
2310,7180,-9491,-1,20516,-27119,-1,124,1
911984,-791080,-121555,-651,-1304806,-198790,-420,130,0
417315,661724,-1076441,2598,993738,-1619224,837,130,0
230108,-1034839,807330,2599,-1554707,1212008,-212,130,0
599322,25350,-623374,1298,59071,-1442848,209,130,0
349713,-230109,-119605,-1,-1052601,-556150,-1258,130,0
-227509,1030938,-804081,-652,1554706,-1211800,627,130,0
-5040,296,4744,0,854,13698,-1,124,1
8008,-9043,1034,-1,-25838,2956,0,124,1
332,-562,230,0,-16244,6643,-1,124,1
30000,30000,30000,90000,60000,60000,180000,124,1
399,-546,146,-1,-15777,4227,-1,124,1
30000,30000,30000,90000,60000,60000,180000,124,1
50051,-953586,908084,4549,-1449133,1377911,208,130,0
-871683,957485,-85154,648,1477410,-133644,1465,130,0
68902,-889234,821630,1298,-1467985,1354869,-211,130,0
559020,-208008,-352964,-1952,-595741,-1019295,-421,130,0
-760529,-170957,931484,-2,-283836,1535015,417,130,0
-1013388,167706,848281,2599,250319,1272965,1045,130,0
-661075,-398465,1066689,7149,-609357,1617548,417,130,0
204988,6293,-211281,0,8144,-273423,0,124,1
0,122,-122,0,14145,-14145,0,124,1
-315912,-653925,971786,1949,-1080461,1600999,-421,130,0
-971137,114404,859332,2599,174281,1319468,837,130,0
-772229,-274961,1051739,4549,-415175,1575653,418,130,0
393264,-1073841,683175,2598,-1614406,1025578,-420,130,0
706576,-345813,-360114,649,-798091,-834959,-211,130,0
-221,1320,-1099,0,15249,-12694,0,124,1
0,0,0,0,0,0,0,124,1
192407,160556,-351014,1949,751378,-1631374,627,130,0
215808,-561622,346462,648,-1618805,1001069,-420,130,0
-534321,-524570,1062789,3898,-811079,1633468,418,130,0
482,14,-497,-1,427,-14354,0,124,1
-161857,-763779,926934,1298,-1261864,1529150,-2,130,0
30000,30000,30000,90000,60000,60000,180000,124,1
54,86,-140,0,9943,-16194,-1,124,1
91,-139,47,-1,-16060,5452,0,124,1
-205408,1023138,-817731,-1,1544442,-1232957,1046,130,0
129354,-542121,412765,-2,-1564133,1190642,-630,130,0
-130005,-865833,999087,3249,-1305644,1503385,208,130,0
-63703,-77353,143655,2599,-884185,1631373,208,130,0
592,-557,-34,1,-1055,-65,1,124,1
1017938,-771579,-243760,2599,-1188339,-376632,-629,130,0
-259360,-782630,1045889,3899,-1179122,1568740,208,130,0
240416,-120208,-120208,0,-155563,-155563,0,124,1
-831,1406,-575,0,16244,-6643,1,124,1
347,-664,317,0,-1258,600,-1,124,1
-4301,-1030,5332,1,-2976,15397,1,124,1
-4823,-148,4971,0,-427,14354,0,124,1
5040,-296,-4744,0,-854,-13698,1,124,1
512869,-990638,478417,648,-1633469,791387,-631,130,0
-2568,5649,-3080,1,16311,-8896,0,124,1
-21850,-47314,69165,1,-75703,110664,0,124,1
-20801,-928885,952935,3249,-1398440,1430488,-421,130,0
-527820,1071890,-543421,649,1633886,-827627,1464,130,0
608422,-618824,11700,1298,-1426719,23670,-839,130,0
-5851,-302912,311361,2598,-1398440,1430279,-420,130,0
5200,485568,-492069,-1301,1408284,-1420854,417,130,0
226858,-349714,126104,3248,-1611683,573326,-420,130,0
752728,-1056940,306161,1949,-1587594,459373,-211,130,0
-54,140,-86,0,16194,-9943,1,124,1
-293812,963336,-670826,-1302,1594296,-1107064,626,130,0
191107,161856,-351014,1949,757034,-1631583,418,130,0
-40302,507018,-468018,-1302,1469869,-1352147,836,130,0
-107255,132604,-24701,648,1540671,-298709,1045,130,0
141055,-52652,-87104,1299,-587990,-1025788,-420,130,0
-165107,-761829,928884,1948,-1258512,1531035,-211,130,0
77352,-338013,263259,2598,-1556802,1206562,-421,130,0
-4301,5332,-1030,1,15397,-2976,1,124,1
60290,-62141,1850,-1,-99426,2961,0,124,1
546020,-664975,121554,2599,-1532922,277132,-2,130,0
-223609,-785230,1011437,2598,-1211381,1554706,-211,130,0
537570,-423816,-113755,-1,-1220807,-329501,-420,130,0
0,122,-122,0,14145,-14145,0,124,1
706576,246359,-953586,-651,405539,-1572721,209,130,0
1050439,-766379,-282111,1949,-1152938,-426068,-630,130,0
-132,-410,542,0,-11848,15661,0,124,1
1012737,-165757,-845032,1948,-250949,-1271919,207,130,0
522,-73,-448,1,-2132,-12958,0,124,1
-532370,-525870,1062789,4549,-812964,1633468,208,130,0
-1306,184,1121,-1,2132,12958,0,124,1
-99454,-35752,138455,3249,-416642,1575653,208,130,0
-118955,123504,-1951,2598,1438239,-47341,1256,130,0
455667,-1071891,619473,3249,-1627394,939275,-211,130,0
280160,-702677,425765,3248,-1622157,979913,-420,130,0
722177,342562,-1063440,1299,512998,-1598906,417,130,0
906783,64352,-967887,3248,94262,-1458978,417,130,0
-141056,70202,71502,648,819247,814429,1045,130,0
-497269,-588273,1087490,1948,-885232,1631582,-2,130,0
969186,-915235,-52002,1949,-1373932,-78972,-630,130,0
-1064740,354263,714376,3899,530803,1072709,1045,130,0
-821631,990637,-167057,1949,1527474,-260166,1674,130,0
-664,332,332,0,629,629,0,124,1
-136506,96853,41601,1948,1126334,461677,836,130,0
367,-556,188,-1,-16060,5452,0,124,1
-92003,-146356,238359,0,-189402,308465,0,124,1
-626624,27301,600622,1299,62213,1382310,418,130,0
-62403,969186,-906784,-1,1459605,-1365134,1046,130,0
-378965,-666275,1049139,3899,-1028721,1613149,-420,130,0
-37609,224447,-186838,0,290462,-241791,1,124,1
549920,-393265,-156656,-1,-1131572,-454347,-421,130,0
-189808,996487,-806031,648,1538786,-1244687,1256,130,0
135855,-30552,-104004,1299,-342069,-1212009,-210,130,0
566821,-286011,-280811,-1,-823019,-810660,-630,130,0
-3059,9683,-6624,0,27666,-18925,1,124,1
-21451,-110505,133905,1949,-1269405,1524751,-2,130,0
-61753,139755,-75403,2599,1631373,-893820,1256,130,0
1067990,-421216,-644825,1949,-640568,-980961,-211,130,0
1748,-5533,3785,0,-15977,10929,-1,124,1
64,77,-141,0,8896,-16311,0,124,1
0,0,0,0,0,0,0,124,1
-106604,132604,-24051,1949,1541090,-300384,1046,130,0
140,-80,-60,0,-9251,-7032,0,124,1
-887934,63702,826180,1948,104107,1359896,836,130,0
572021,514169,-1084891,1299,772535,-1632212,627,130,0
-85154,525869,-440717,-2,1522447,-1274223,836,130,0
0,0,0,0,0,0,0,124,1
996487,-876233,-119605,649,-1315698,-180985,-420,130,0
131954,-20151,-110505,1298,-218062,-1292447,208,130,0
30000,30000,30000,90000,60000,60000,180000,124,1
-58503,967236,-908085,648,1457720,-1367229,1046,130,0
-575272,1057589,-482319,-2,1632001,-744466,1256,130,0
-241810,-709177,952935,1948,-1173048,1570835,-212,130,0
124804,-993888,872982,3898,-1498568,1312765,-1,130,0
1075140,-497919,-575272,1949,-757454,-874339,-1,130,0
0,8573,-8573,0,24494,-24494,0,124,1
-10401,-117005,130004,2598,-1343139,1476782,-211,130,0
0,0,0,0,0,0,0,124,1
588272,395214,-982837,649,649993,-1622157,836,130,0
335412,226858,-562272,-2,656696,-1623204,417,130,0
-108555,966586,-858033,-2,1491236,-1323030,1046,130,0
-37609,224447,-186838,0,290462,-241791,1,124,1
-537,-69,607,1,-131,1149,0,124,1
-642875,-436817,1082940,3248,-657954,1623622,417,130,0
-455668,516769,-61753,-652,1496891,-181194,836,130,0
-787180,-219059,1012087,5848,-340603,1553658,208,130,0
0,0,0,0,0,0,0,124,1
-5040,296,4744,0,854,13698,-1,124,1
354913,-183307,-170957,649,-841452,-791807,-629,130,0
-119605,122854,-1951,1298,1436773,-45037,837,130,0
900933,-962037,65002,3898,-1460863,97195,-1,130,0
-21850,69165,-47314,1,110664,-75703,0,124,1
603872,-1074491,473867,3248,-1630117,718491,-211,130,0
-504419,33151,473867,2599,93005,1365971,627,130,0
-44,-466,510,0,-13461,14742,0,124,1
116354,13650,-127405,2599,168625,-1491027,208,130,0
-783280,-241160,1030938,6498,-369720,1562875,417,130,0
549920,-391965,-157956,-1,-1130106,-456441,-420,130,0
0,0,0,0,0,0,0,124,1
315261,-1057590,745577,3248,-1590317,1119003,-629,130,0
314611,655874,-969187,1298,1081298,-1600581,209,130,0
-233773,165491,68281,-1,214165,88364,-1,124,1
-146256,918484,-774180,-1952,1520143,-1278412,1256,130,0
-704627,298361,408215,1949,688536,938647,837,130,0
-767029,1016638,-248310,1299,1567903,-385430,1256,130,0
-139756,59802,81253,1299,707389,921679,1046,130,0
0,0,0,0,0,0,0,124,1
609722,-618174,11050,2598,-1425672,21575,-630,130,0
-62403,139755,-74753,2599,1631373,-891516,837,130,0
983486,-889884,-91654,1948,-1340835,-138043,-211,130,0
6429,3304,-9733,0,9441,-27810,0,124,1
204757,810580,-1014038,1299,1234213,-1543186,1465,130,0
917184,-140406,-778730,-1952,-231677,-1284068,-1,130,0
663674,401065,-1062790,1949,609146,-1616711,627,130,0
867132,-1002988,137805,1949,-1506738,206121,-211,130,0
-542121,662374,-118305,1948,1533549,-278390,1255,130,0
-11,127,-116,0,14742,-13461,0,124,1
0,0,0,0,0,0,0,124,1
367,188,-556,-1,5452,-16060,0,124,1
-1078391,436816,644174,2599,656068,967763,836,130,0
5226,-738,-4487,1,-2132,-12958,0,124,1
-371814,-183957,555770,-1,-532480,1603513,-211,130,0
0,0,0,0,0,0,0,124,1
771578,-1018589,248309,1298,-1566647,381868,-630,130,0
937335,4550,-941886,-1,4608,-1416664,-1,130,0
623373,-1083591,463467,3249,-1628232,695449,-630,130,0
-656,238,418,0,451,792,0,124,1
174,378,-553,-1,10929,-15977,-1,124,1
-750779,1053039,-300962,1298,1586755,-454766,1464,130,0
-222309,-785880,1010787,2598,-1212638,1554077,-2,130,0
-705277,297061,409515,1299,686023,940951,837,130,0
1052389,-646125,-404316,1948,-995624,-623810,-420,130,0
-522,73,448,-1,2132,12958,0,124,1
-380915,-686426,1072540,5199,-1035843,1611892,-1,130,0
-598023,1080340,-482319,-2,1630744,-727290,1464,130,0
-967887,911984,57202,1299,1371836,82951,1256,130,0
1060839,-577222,-481019,2598,-890888,-740068,-212,130,0
-986087,107254,884683,5850,158361,1329104,1046,130,0
999,366,-1366,-1,4227,-15777,-1,124,1
-1748,-3785,5533,0,-10929,15977,1,124,1
-102054,342562,-239209,1299,1592620,-1111672,836,130,0
831,-1406,575,0,-16244,6643,-1,124,1
22750,108554,-131305,-1,1269613,-1524543,1045,130,0
-214212,12582,201630,0,16283,260933,0,124,1
-8008,9043,-1034,1,25838,-2956,0,124,1
313961,656524,-969837,648,1082554,-1600372,207,130,0
172256,841131,-1015339,-1952,1266262,-1526637,1046,130,0
181356,-354264,176156,3248,-1633887,805841,-839,130,0
-90354,137805,-46152,1299,1606446,-545258,837,130,0
1034188,-225559,-807331,1298,-341232,-1212638,-212,130,0
0,0,0,0,0,0,0,124,1
-36946,-33740,70686,0,-53984,113098,1,124,1
-430,533,-103,0,15397,-2976,1,124,1
0,0,0,0,0,0,0,124,1
550,-389,-160,1,-11243,-4639,0,124,1
-292511,1039388,-746878,-1,1584451,-1137437,1256,130,0
104003,-345163,243759,2599,-1591155,1116489,-839,130,0
362063,344512,-705927,648,797671,-1632631,836,130,0
109204,24050,-131305,1949,293052,-1537739,209,130,0
-1053040,650024,404965,1949,999394,619829,1255,130,0
-81904,139105,-55903,1298,1625508,-670313,1046,130,0
839181,161206,-998438,1949,242988,-1519725,836,130,0
100,36,-136,0,4227,-15777,0,124,1
-784580,-257410,1045239,3249,-388991,1568322,209,130,0
-649375,82553,569421,2599,189572,1310042,417,130,0
6429,-9733,3304,0,-27810,9441,0,124,1
-1062140,333462,731927,3249,499801,1096798,417,130,0
241159,711126,-951636,649,1173047,-1570836,628,130,0
173556,841781,-1015339,-2,1265633,-1527266,836,130,0
-211258,-479718,691625,649,-1106854,1593668,-210,130,0
-905484,-62403,971786,3899,-97615,1461071,836,130,0
-768979,1015988,-245060,1949,1566646,-380822,1674,130,0
-588923,-493369,1086840,4548,-744257,1631373,418,130,0
254809,-564872,312011,1948,-1630745,900942,-420,130,0
-533670,-547321,1086190,5199,-827837,1633468,208,130,0
1064739,-352314,-711127,1298,-533108,-1070406,-211,130,0
256,-564,308,0,-16311,8896,0,124,1
-796280,906133,-110505,-652,1498148,-184127,1046,130,0
-42252,507669,-467368,-1951,1471755,-1349633,837,130,0
-376365,704626,-326963,1298,1632630,-759758,1256,130,0
127404,-9101,-116355,1948,-87560,-1368276,418,130,0
705276,-1071891,369213,2598,-1608122,553426,-630,130,0
-22,132,-109,1,15249,-12694,0,124,1
382864,665624,-1046540,1948,1024321,-1613359,837,130,0
-2955,5654,-2699,0,16328,-7793,1,124,1
-1748,-3785,5533,0,-10929,15977,1,124,1
437466,640924,-1078391,-1,964831,-1623414,1046,130,0
-1012738,165756,850231,3249,247806,1274222,418,130,0
-330,-1025,1355,0,-11848,15661,0,124,1
142355,-62403,-78003,1949,-706133,-922518,-420,130,0
-600623,-454368,1059539,4548,-702362,1628231,209,130,0
1055639,-705277,-349064,1298,-1071663,-531852,-212,130,0
3788,-9814,6026,0,-28042,17218,-1,124,1
-662,376,286,0,712,541,-1,124,1
-134,29,105,0,3396,12138,0,124,1
-263260,334112,-69553,1299,1550516,-328663,1255,130,0
204107,811230,-1014038,1299,1235050,-1543186,1045,130,0
655874,420565,-1075791,648,631769,-1620062,627,130,0
-1050440,766378,286010,1948,1152728,426486,1256,130,0
0,0,0,0,0,0,0,124,1
170956,-553821,382864,-1,-1594926,1103292,-631,130,0
-324363,283410,42251,1298,1312555,186430,1045,130,0
227508,-349714,125454,3248,-1611264,570813,-629,130,0
482318,-499869,17550,-1,-1439916,51949,-211,130,0
850881,-998438,150805,3248,-1515326,228325,-1,130,0
-670176,-375065,1048489,3248,-580449,1612520,418,130,0
-738,1413,-674,1,16328,-7793,1,124,1
-3673,-1888,5562,1,-5452,16060,0,124,1
-128055,111154,20150,3249,1296845,211776,627,130,0
-137,97,40,0,11243,4639,0,124,1
-722178,-339963,1066039,3898,-513628,1599323,-2,130,0
35101,-136506,104653,3248,-1565599,1186662,-839,130,0
109204,-133906,27301,2599,-1541301,300593,-840,130,0
50000,-68301,18301,0,-109282,29282,0,124,1
608422,473867,-1080341,1948,712207,-1628651,627,130,0
-9625,6814,2811,0,19469,8033,0,124,1
-921085,141055,780029,-1,231676,1284695,836,130,0
-20151,315261,-292511,2599,1462328,-1361573,836,130,0
-911985,789779,122854,648,1304595,200255,1464,130,0
661074,403665,-1063440,1299,613964,-1617339,627,130,0
-287311,1048489,-759229,1949,1581309,-1145816,627,130,0
-979587,365963,615573,1949,602024,1014266,836,130,0
-9414,7356,2058,0,21019,5880,0,124,1
-1025089,824880,202157,1948,1240916,300383,1255,130,0
1067990,-419266,-646125,2599,-638473,-982846,-420,130,0
-956186,923684,34451,1949,1390270,48178,1255,130,0
1051739,-645475,-404966,1298,-994577,-625067,-630,130,0
143005,-72153,-68903,1949,-819039,-814430,-420,130,0
-1344,1050,294,0,12138,3396,0,124,1
-364664,555120,-190458,-2,1608121,-551961,1046,130,0
1067990,-703977,-364014,-1,-1058047,-549028,-420,130,0
142355,-81254,-58503,2598,-931735,-696078,-211,130,0
3900,486868,-492069,-1301,1410170,-1418968,837,130,0
30000,30000,30000,90000,60000,60000,180000,124,1
-437,-946,1383,0,-10929,15977,1,124,1
1058239,-580472,-477118,649,-895287,-735250,-212,130,0
-202158,-811881,1017938,3899,-1234633,1543813,207,130,0
-202808,1022488,-819031,649,1542975,-1235889,836,130,0
-891834,-89704,984786,3248,-137415,1478248,417,130,0
643524,438116,-1079041,2599,656277,-1622995,417,130,0
-607773,615573,-6501,1299,1424623,-19063,1464,130,0
-140406,59802,81253,649,703828,924402,417,130,0
-87104,-253510,342562,1948,-1165297,1573768,-630,130,0
393264,-1073841,683175,2598,-1613988,1026416,-2,130,0
559020,-358814,-200858,-652,-1034586,-577517,-421,130,0
-709177,-357514,1071240,4549,-540021,1605189,418,130,0
529769,-1084891,558370,3248,-1633678,840404,-1,130,0
1044589,-269111,-774180,1298,-406796,-1166344,209,130,0
116354,230108,-345163,1299,1072290,-1602676,627,130,0
852181,-997788,149505,3898,-1514069,225602,-1,130,0
851531,-998438,150155,3248,-1514279,226021,-211,130,0
-2955,5654,-2699,0,16328,-7793,1,124,1
-8440,8699,-259,0,24856,-740,0,124,1
109146,-240086,130940,0,-310700,169451,-1,124,1
44851,-139756,96853,1948,-1597020,1096798,-840,130,0
-872333,956835,-84504,-2,1476782,-132806,1256,130,0
646,-457,-188,1,-866,-357,0,124,1
-664,332,332,0,629,629,0,124,1
1083590,-508320,-575272,-2,-766461,-865961,-2,130,0
-627924,30551,599322,1949,67450,1379377,208,130,0
504,-474,-29,1,-13698,-854,1,124,1
141705,-52002,-87104,2599,-586315,-1027045,-211,130,0
550,-160,-389,1,-4639,-11243,0,124,1
222115,-31380,-190735,0,-40610,-246833,0,124,1
67249,-52548,-14701,0,-84077,-23522,0,124,1
-137156,40301,99453,2598,464191,1124239,627,130,0
-330,-1025,1355,0,-11848,15661,0,124,1
0,0,0,0,0,0,0,124,1
-352964,157305,196307,648,730221,900523,837,130,0
-298362,-750779,1054339,5198,-1134086,1585289,-211,130,0
-70492,30441,40050,-1,48706,64081,-1,124,1
606472,-1074491,470617,2598,-1629698,713882,-2,130,0
893133,90353,-980237,3249,132805,-1475945,208,130,0
-1320,5423,-4103,0,15661,-11848,0,124,1
-207358,1024438,-815781,1299,1545489,-1230862,1255,130,0
657824,417965,-1075791,-2,628837,-1619643,628,130,0
-1396,889,506,-1,10279,5853,-1,124,1
0,0,0,0,0,0,0,124,1
-410166,-293812,705926,1948,-680158,1626136,208,130,0
55902,85153,-138456,2599,993319,-1619224,627,130,0
-341263,245709,97503,1949,1143301,439054,836,130,0
-598673,-25351,627273,3249,-62633,1444733,418,130,0
-971137,62402,912634,3899,90911,1367018,627,130,0
728677,302911,-1030289,1299,464400,-1588013,207,130,0
139,-88,-50,1,-10279,-5853,1,124,1
155,482,-637,0,912,-1206,-1,124,1
-286011,-750779,1041989,5199,-1144350,1581937,208,130,0
-74292,235162,-160869,1,304328,-208184,1,124,1
-137,97,40,0,11243,4639,0,124,1
936685,5850,-942536,-1,7541,-1417921,418,130,0
-334113,265859,69552,1298,1231908,313580,1045,130,0
-113105,-233359,349063,2599,-1074595,1602675,-211,130,0
-1086191,564871,523269,1949,848364,785103,1046,130,0
523919,-78003,-447217,-1301,-223717,-1289095,-210,130,0
968536,-57203,-910035,1298,-88398,-1367857,418,130,0
-67249,52548,14701,0,84077,23522,0,124,1
-505069,1058889,-552521,1299,1633677,-852554,1256,130,0
205,444,-650,-1,842,-1231,-1,124,1
-11,-116,127,0,-13461,14742,0,124,1
66952,-888584,822280,648,-1466728,1356335,-1,130,0
539520,-122205,-418616,-1301,-348773,-1207401,-211,130,0
768978,-1019239,250259,-2,-1567694,385639,-420,130,0
1040688,-250260,-788480,1948,-378727,-1186454,-211,130,0
-5587,3559,2027,-1,10279,5853,-1,124,1
92003,-238359,146356,0,-308465,189402,0,124,1
-211908,558370,-347114,-652,1618385,-1002746,836,130,0
-273661,1023138,-748179,1298,1578376,-1154823,1046,130,0
-334113,1061489,-726078,1298,1597857,-1093657,1046,130,0
30000,30000,30000,90000,60000,60000,180000,124,1
1038088,-246360,-791080,648,-372443,-1191062,-211,130,0
-750779,1053039,-300962,1298,1586965,-455604,1255,130,0
30000,30000,30000,90000,60000,60000,180000,124,1
-606473,616223,-7801,1949,1426508,-23252,1255,130,0
-141706,-839182,982186,1298,-1292238,1511554,207,130,0
-848282,1008837,-157306,3249,1519724,-239847,1465,130,0
-107,133,-25,1,15397,-2976,1,124,1
2955,-5654,2699,0,-16328,7793,-1,124,1
945785,-935386,-8451,1948,-1407866,-13616,-210,130,0
-100104,-555771,657824,1949,-1284278,1516163,-2,130,0
90353,249609,-339313,649,1165506,-1573559,837,130,0
550570,-166407,-386765,-2602,-476132,-1115024,-421,130,0
273010,57202,-330213,-1,272314,-1530198,627,130,0
826180,198257,-1023139,1298,295775,-1538577,418,130,0
1067990,-640274,-427066,650,-973420,-649366,-211,130,0
-893134,961386,-65653,2599,1463795,-102642,1465,130,0
522619,464767,-989338,-1952,768136,-1632002,627,130,0
-1051740,765078,287310,648,1150842,429209,1255,130,0
213207,-560972,349063,1298,-1617758,1005678,-1,130,0
470,-642,172,0,-1215,325,0,124,1
991287,-825531,-165107,649,-1270662,-254091,-630,130,0
110,1165,-1276,-1,13461,-14742,0,124,1
-1053690,705926,352313,4549,1071452,532479,1046,130,0
1083590,-510920,-572022,648,-771488,-861143,-420,130,0
918,-1390,472,0,-16060,5452,0,124,1
1344,-1050,-294,0,-12138,-3396,0,124,1
380264,689025,-1068641,648,1038775,-1610636,837,130,0
-898334,974386,-73453,2599,1468822,-114582,1465,130,0
692275,-1073191,384164,3248,-1612312,576887,-421,130,0
-4551,-303562,310061,1948,-1401582,1427137,-630,130,0
740377,317861,-1055640,2598,475084,-1590527,418,130,0
520669,553170,-1073191,648,840404,-1632631,627,130,0
-60290,-1850,62141,1,-2961,99426,0,124,1
-139106,89053,51351,1298,1033119,579401,837,130,0
102053,35751,-134556,3248,421877,-1576911,417,130,0
457617,624023,-1079041,2599,938018,-1626556,1255,130,0
-592,34,557,-1,65,1055,-1,124,1
730627,302261,-1030289,2599,462515,-1587385,626,130,0
-139106,50051,90353,1298,590503,1023902,627,130,0
88403,893133,-981537,-1,1343557,-1476155,836,130,0
0,0,0,0,0,0,0,124,1
-91004,137805,-46152,649,1606864,-547353,1045,130,0
0,0,0,0,0,0,0,124,1
-8440,-259,8699,0,-740,24856,0,124,1
707876,362713,-1067991,2598,543162,-1605399,627,130,0
65002,-970487,908734,3249,-1460235,1364505,-211,130,0
-457,516,-59,0,14922,-1707,1,124,1
-62403,640273,-576572,1298,1482857,-1334970,1465,130,0
1144,-1291,147,0,-14922,1707,-1,124,1
135855,-31202,-104004,649,-343955,-1210334,207,130,0
-55253,-889884,946435,1298,-1370580,1455416,-210,130,0
959435,-923685,-33802,1948,-1388385,-51531,-420,130,0
927584,-958136,33151,2599,-1438659,48597,-630,130,0
-459568,-55903,516769,1298,-163599,1489350,626,130,0
522619,-451767,-70203,649,-1302502,-202770,-630,130,0
-521970,449166,72152,-652,1300615,206749,1464,130,0
3673,-5562,1888,-1,-16060,5452,0,124,1
-564222,324362,240509,649,935923,691888,836,130,0
-1344,1050,294,0,12138,3396,0,124,1
-131305,-863883,999737,4549,-1304387,1503804,-1,130,0
531719,137155,-669526,-652,319236,-1546537,627,130,0
704626,247659,-954236,-1951,407005,-1573140,208,130,0
230758,-1034839,806680,2599,-1554916,1211171,-420,130,0
847631,19500,-866483,648,30373,-1429023,208,130,0
-70492,30441,40050,-1,48706,64081,-1,124,1
-98804,135855,-35752,1299,1578795,-425440,836,130,0
-131955,-863883,1000387,4549,-1303340,1504851,-2,130,0
-783280,-241160,1030288,5848,-369301,1562666,627,130,0
-847632,1008187,-159256,1299,1520562,-242570,1046,130,0
167706,-1014038,848931,2599,-1523286,1272756,208,130,0
-273011,1022488,-748829,648,1577957,-1155242,837,130,0
1025738,-822281,-203458,-1,-1236518,-306459,-630,130,0
-291211,563571,-272361,-1,1633677,-788246,1256,130,0
382864,664974,-1047190,648,1023483,-1613569,836,130,0
537,-607,69,-1,-1149,131,0,124,1
193707,826830,-1021839,-1302,1245524,-1537739,1046,130,0
-746878,934735,-188508,-651,1544861,-311486,1256,130,0
989337,-503119,-487519,-1301,-830560,-802700,-421,130,0
-989988,826830,165756,2598,1272965,250948,1046,130,0
579821,-644175,66302,1948,-1484324,151239,-420,130,0
-228649,49985,178664,0,64686,231212,-1,124,1
-380265,-685776,1072540,6499,-1036262,1611892,208,130,0
369863,184606,-555771,-1302,536459,-1603723,418,130,0
666274,381564,-1046540,1298,585057,-1612731,627,130,0
676675,-521320,-154056,1299,-1201955,-357361,-840,130,0
180706,-354264,176156,2598,-1634097,807936,-839,130,0
301,-663,362,0,-1256,685,0,124,1
-125617,240333,-114716,0,311020,-148456,1,124,1
30000,30000,30000,90000,60000,60000,180000,124,1
-428367,1053039,-624024,648,1624670,-962737,1256,130,0
43,-138,94,-1,-15977,10929,-1,124,1
-822281,989987,-165107,2599,1526636,-257861,1674,130,0
5547,-63822,58274,-1,-102115,93239,0,124,1
-969837,112454,859982,2599,170929,1321353,626,130,0
-373114,1057589,-682526,1949,1611263,-1039613,836,130,0
2955,-5654,2699,0,-16328,7793,-1,124,1
1019888,-187858,-829432,2598,-286978,-1248667,208,130,0
986086,-100754,-883384,1948,-154801,-1330362,626,130,0
-353614,182006,172256,648,843546,789921,1046,130,0
604522,-1074491,473217,3248,-1630117,717653,-211,130,0
1058239,-751429,-303562,3248,-1129687,-457489,-630,130,0
-537,-69,607,1,-131,1149,0,124,1
45501,-139756,96853,2598,-1597649,1094704,-839,130,0
-3251,-488169,492718,1298,-1408704,1420853,-420,130,0
1043289,-780680,-260010,2599,-1177656,-391714,-420,130,0
-41562,70323,-28760,1,112517,-46016,1,124,1
531719,134555,-668226,-1952,315256,-1545071,627,130,0
0,0,0,0,0,0,0,124,1
597372,27301,-624674,-1,64517,-1445362,417,130,0
-792380,1036788,-242460,1948,1562666,-367835,1465,130,0
0,0,0,0,0,0,0,124,1
93603,-141056,49401,1948,-1606656,546933,-420,130,0
-143656,1002987,-858033,1298,1511135,-1293075,1046,130,0
-63053,-77353,142355,1949,-885651,1631373,208,130,0
-400,-146,546,0,-4227,15777,0,124,1
-967887,912634,55252,-1,1373302,79809,1046,130,0
-443,5105,-4661,1,14742,-13461,0,124,1
-366614,-687726,1061489,7149,-1048411,1609169,-1,130,0
-52,599,-547,0,1136,-1037,1,124,1
170306,843731,-1014689,-652,1268566,-1525381,836,130,0
-393265,1071240,-677326,649,1615243,-1020551,1255,130,0
-1038089,713076,326962,1949,1097008,499801,836,130,0
205,444,-650,-1,842,-1231,-1,124,1
-169007,550570,-381565,-2,1595343,-1102455,627,130,0
1000,-1366,366,0,-15777,4227,0,124,1
100753,554470,-655225,-2,1284905,-1515745,1255,130,0
0,0,0,0,0,0,0,124,1
-114405,-232059,349063,2599,-1070196,1603722,-420,130,0
-1051090,765728,287310,1948,1151471,428162,1256,130,0
30000,30000,30000,90000,60000,60000,180000,124,1
-558,355,202,-1,10279,5853,-1,124,1
-343863,105303,241809,3249,488280,1105806,627,130,0
130654,-350364,222308,2598,-1615663,1018665,-1049,130,0
0,1224,-1224,0,14145,-14145,0,124,1
943185,-922385,-18201,2599,-1399488,-30165,-212,130,0
50051,911984,-962687,-652,1375607,-1450389,1047,130,0
-372464,1056289,-683826,-1,1610844,-1041289,1255,130,0
-1260,74,1186,0,854,13698,-1,124,1
173556,841781,-1015339,-2,1265843,-1526847,1046,130,0
-651325,86453,567471,2599,196694,1306062,836,130,0
174856,841131,-1015989,-2,1264167,-1527685,836,130,0
-460218,-596723,1059539,2598,-921052,1628859,-2,130,0
-147556,919134,-774180,-2602,1520981,-1276527,837,130,0
214212,-201630,-12582,0,-260933,-16283,0,124,1
30000,30000,30000,90000,60000,60000,180000,124,1
55252,-141706,87753,1299,-1619643,994995,-629,130,0
1144,147,-1291,0,1707,-14922,-1,124,1
458267,622723,-1079691,1299,937809,-1626765,837,130,0
30000,30000,30000,90000,60000,60000,180000,124,1
30000,30000,30000,90000,60000,60000,180000,124,1
570071,516769,-1084891,1949,775677,-1632421,418,130,0
-295112,962686,-670176,-2602,1594296,-1106016,627,130,0
469,-642,172,-1,-1215,325,-1,124,1
213858,-561622,347763,-1,-1617968,1003583,-2,130,0
-865183,1000387,-133906,1298,1506527,-205074,1256,130,0
30000,30000,30000,90000,60000,60000,180000,124,1
141,-70,-70,1,-8167,-8167,0,124,1
-727378,-319812,1051739,4549,-488072,1594087,418,130,0
86453,-527170,442016,1299,-1522239,1274850,-421,130,0
30000,30000,30000,90000,60000,60000,180000,124,1
370513,184606,-555771,-652,535621,-1603723,208,130,0
1034188,-226209,-806681,1298,-342069,-1212219,-420,130,0
645474,-1053690,410815,2599,-1620691,630512,-421,130,0
0,0,0,0,0,0,0,124,1
550570,-1086841,538870,2599,-1633887,809611,-630,130,0
131954,-20151,-111155,648,-216805,-1293494,-1,130,0
30000,30000,30000,90000,60000,60000,180000,124,1
-784580,-256110,1044589,3899,-386478,1567693,417,130,0
-431,653,-221,1,1237,-420,0,124,1
-1003638,865182,139105,649,1301034,205702,1465,130,0
68902,-889884,820330,-652,-1468195,1354869,-211,130,0
167056,185906,-351664,1298,866588,-1632002,627,130,0
431,221,-653,-1,420,-1237,0,124,1
30000,30000,30000,90000,60000,60000,180000,124,1
93603,436816,-528470,1949,1263539,-1528313,1046,130,0
1344,-1050,-294,0,-12138,-3396,0,124,1
852181,-1009488,159255,1948,-1519306,239217,-2,130,0
0,0,0,0,0,0,0,124,1
-138456,88403,52001,1948,1030186,583171,1045,130,0
-1040039,252859,791729,4549,377679,1187710,837,130,0
-1056290,436816,622723,3249,669893,955404,836,130,0
141,-70,-70,1,-8167,-8167,0,124,1
1026388,-824231,-200208,1949,-1239869,-301851,-839,130,0
50701,-953586,907433,4548,-1449970,1377073,418,130,0
-664,332,332,0,629,629,0,124,1
-939936,919134,22750,1948,1399068,31420,1465,130,0
-138456,50051,90353,1948,587780,1025997,627,130,0
1069290,-701377,-366614,1299,-1055114,-552589,-420,130,0
-538871,119604,419265,-2,345839,1209914,837,130,0
-191108,997137,-806031,-2,1538995,-1244059,836,130,0
-874283,956185,-81254,648,1474687,-127779,1464,130,0
5547,58274,-63822,-1,93239,-102115,0,124,1
336062,-267811,-65653,2598,-1233376,-311067,-630,130,0
1006887,-174857,-828782,3248,-267707,-1261236,207,130,0
9414,-2058,-7356,0,-5880,-21019,0,124,1
-3325,5625,-2300,0,16244,-6643,1,124,1
-349714,131304,219708,1298,613336,1004421,627,130,0
0,0,0,0,0,0,0,124,1
-221,-1099,1320,0,-12694,15249,0,124,1
-388065,-594123,982836,648,-981590,1621528,-211,130,0
-965287,289260,677975,1948,475084,1116279,836,130,0
-437467,-640274,1081640,3899,-965251,1623832,208,130,0
-482,497,-14,1,14354,-427,0,124,1
331512,-707877,378964,2599,-1632631,870987,-840,130,0
918,472,-1390,0,5452,-16060,0,124,1
-485569,-10401,496618,648,-30374,1429651,627,130,0
947735,-16251,-928885,2599,-27860,-1400116,418,130,0
-705277,393264,315261,3248,908064,722680,1465,130,0
700726,-438117,-261960,649,-1010497,-606633,-839,130,0
-738,1413,-674,1,16328,-7793,1,124,1
74292,-235162,160869,-1,-304328,208184,-1,124,1
529119,-1084241,559020,3898,-1633678,840613,-2,130,0
-287311,1048489,-760529,649,1580680,-1147282,627,130,0
390,-661,270,-1,-1251,511,-1,124,1
-191108,997787,-806031,648,1539205,-1243640,1465,130,0
-1061490,331512,733877,3899,495821,1099731,417,130,0
-145606,1003637,-857383,648,1511554,-1292028,627,130,0
32101,-70613,38511,-1,-112982,61618,-1,124,1
458267,-518720,61752,1299,-1495635,178470,-420,130,0
-705927,393914,313961,1948,909739,720586,1255,130,0
332,230,-562,0,6643,-16244,-1,124,1
-848282,1008187,-158606,1299,1520562,-241732,1465,130,0
0,0,0,0,0,0,0,124,1
-22,-109,132,1,-12694,15249,0,124,1
131954,-113755,-16901,1298,-1296217,-212615,-210,130,0
-237456,151298,86157,-1,195798,111497,-1,124,1
-113755,-232709,349713,3249,-1071663,1603303,-631,130,0
903533,68252,-969187,2598,99708,-1461282,626,130,0
570721,517419,-1084891,3249,775258,-1632212,836,130,0
-391965,1071240,-677976,1299,1614824,-1021808,836,130,0
347,317,-664,0,600,-1258,-1,124,1
-340613,-722178,1067339,4548,-1087373,1599323,-421,130,0
1058889,-577222,-481669,-2,-890050,-741115,-421,130,0
61752,269760,-330213,1299,1254112,-1533131,1045,130,0
-4576,-591,5167,0,-1707,14922,1,124,1
-872983,956835,-83204,648,1476363,-131549,1465,130,0
-395865,546670,-150156,649,1581728,-436542,627,130,0
537570,-423816,-113105,649,-1222064,-328035,-630,130,0
-1077091,413415,666274,2598,621086,998137,1255,130,0
-565522,245059,319811,-652,709274,920004,837,130,0
-549921,390664,159255,-2,1130733,455603,418,130,0
4301,-5332,1030,-1,-15397,2976,-1,124,1
-1077091,414715,664974,2598,622552,996671,837,130,0
976986,-629874,-346463,649,-1039613,-571442,-629,130,0
226858,-349714,126104,3248,-1611683,574374,-210,130,0
1075790,-412766,-663025,-1,-622344,-996253,207,130,0
83,-140,57,0,-16244,6643,-1,124,1
85153,55902,-138456,2599,660676,-1623414,836,130,0
30000,30000,30000,90000,60000,60000,180000,124,1
136505,-31202,-104004,1299,-346049,-1209077,-1,130,0
-90354,137805,-46152,1299,1607074,-549028,837,130,0
33,-135,102,0,-15661,11848,0,124,1
-505719,33151,473867,1299,94262,1365133,417,130,0
1058889,-578522,-479068,1299,-892564,-738392,-421,130,0
706576,-394565,-311362,649,-909531,-720168,-211,130,0
691625,-480368,-209958,1299,-1107273,-486606,-630,130,0
-451767,-244410,698776,2599,-567043,1609797,-2,130,0
264559,434866,-698127,1298,1007563,-1616920,417,130,0
564221,-324363,-240510,-652,-933620,-694193,-420,130,0
1075,257,-1333,-1,2976,-15397,-1,124,1
-664975,1060189,-393265,1949,1616291,-600768,1465,130,0
-128055,348413,-218409,1949,1615872,-1016153,627,130,0
-457,-59,516,0,-1707,14922,1,124,1
493368,190457,-684476,-651,442196,-1582567,-2,130,0
865832,-1004288,141055,2599,-1508623,210938,-421,130,0
-11,127,-116,0,14742,-13461,0,124,1
9145,-7853,-1292,0,-22439,-3691,1,124,1
5500,-3893,-1606,1,-11243,-4639,0,124,1
-733228,1044589,-310062,1299,1591364,-474247,1465,130,0
-651,-940586,944485,3248,-1413732,1415616,-211,130,0
-60290,62141,-1850,1,99426,-2961,0,124,1
-239859,-710477,951635,1299,-1174723,1570207,-420,130,0
597372,27951,-624674,649,64936,-1445572,207,130,0
-239675,136173,103501,-1,176224,133943,0,124,1
-113755,-14951,131304,2598,-169254,1491445,627,130,0
-691626,957485,-265860,-1,1582566,-439474,837,130,0
707226,-347114,-358164,1948,-801443,-832026,-630,130,0
345812,-107905,-237259,648,-492680,-1102455,-629,130,0
797579,-909385,113104,1298,-1499197,187478,-420,130,0
503768,-477118,-26001,649,-1374560,-77296,-630,130,0
-44,510,-466,0,14742,-13461,0,124,1
132,410,-542,0,11848,-15661,0,124,1
267810,-336713,70852,1949,-1548632,322378,-630,130,0
-139756,79302,63052,2598,927126,701314,837,130,0
102053,-137156,37701,2598,-1578377,423134,-630,130,0
0,0,0,0,0,0,0,124,1
-459568,-618174,1081640,3898,-934039,1627602,-2,130,0
-1014689,837881,179406,2598,1261653,268125,1255,130,0
50000,-68301,18301,0,-109282,29282,0,124,1
140,-60,-80,0,-7032,-9251,0,124,1
-118955,-3251,125454,3248,-37706,1432793,417,130,0
352963,-1042640,692925,3248,-1605399,1065168,-630,130,0
332,230,-562,0,6643,-16244,-1,124,1
800179,234008,-1032239,1948,350238,-1556173,837,130,0
0,0,0,0,0,0,0,124,1
-80604,978936,-897684,648,1471755,-1349842,1256,130,0
919784,-919785,2600,2599,-1415826,2094,-630,130,0
109204,-133906,26650,1948,-1540253,298498,-1,130,0
365963,-557721,192407,649,-1608751,556987,-631,130,0
23400,-132605,111804,2599,-1522657,1273593,-211,130,0
-21850,69165,-47314,1,110664,-75703,0,124,1
-254160,-85804,341912,1948,-391295,1568950,209,130,0
-88,-439,528,1,-12694,15249,0,124,1
-3059,9683,-6624,0,27666,-18925,1,124,1
691625,-1073191,384814,3248,-1612312,577097,-420,130,0
228158,-694227,468017,1948,-1602257,1077527,-630,130,0
-4000,-1464,5464,0,-4227,15777,0,124,1
172906,-553171,381564,1299,-1596182,1099941,-629,130,0
614,-527,-86,1,-998,-164,0,124,1
-640274,-440067,1083590,3249,-663191,1624251,-1,130,0
49999,-68301,18301,-1,-109282,29282,-1,124,1
-1084241,489468,598672,3899,735249,895705,837,130,0
-482,-14,497,1,-427,14354,0,124,1
624673,-27952,-597373,-652,-63052,-1381473,417,130,0
0,0,0,0,0,0,0,124,1
334762,225558,-562272,-1952,655649,-1622995,208,130,0
56124,-230515,174391,0,-298314,225683,0,124,1
-362064,-344513,708526,1949,-798091,1633049,-1,130,0
527169,-1084891,560971,3249,-1633678,843546,-420,130,0
276910,770928,-1046540,1298,1160059,-1575654,1046,130,0
260009,304861,-565522,-652,882089,-1631374,417,130,0
986086,-101404,-882734,1948,-155220,-1330152,417,130,0
-120255,992587,-871033,1299,1497101,-1314023,836,130,0
586971,395864,-982837,-2,652297,-1622576,626,130,0
481668,-499869,18200,-1,-1440754,53834,-211,130,0
-947736,22100,931484,5848,29535,1399487,627,130,0
-128705,-866483,999737,4549,-1306063,1502966,208,130,0
5500,-1606,-3893,1,-4639,-11243,0,124,1
-49999,-18301,68301,1,-29282,109282,1,124,1
-3059,-6624,9683,0,-18925,27666,1,124,1
1306,-184,-1121,1,-2132,-12958,0,124,1
65002,-142356,78002,648,-1631583,892144,-839,130,0
-469968,1080990,-610373,649,1629069,-919586,1046,130,0
0,0,0,0,0,0,0,124,1
-522,73,448,-1,2132,12958,0,124,1
-166407,-187208,355563,1948,-863447,1632211,-211,130,0
0,0,0,0,0,0,0,124,1
-8451,615573,-605823,1299,1425880,-1402839,1046,130,0
400,-546,146,0,-15777,4227,0,124,1
603222,-1082941,483618,3899,-1630536,727498,-211,130,0
-566,-17,584,1,-32,1106,1,124,1
302261,729977,-1030289,1949,1124030,-1588013,836,130,0
-318512,24700,295111,1299,116257,1352774,417,130,0
1066689,-640925,-425116,648,-975096,-647271,-211,130,0
-431,653,-221,1,1237,-420,0,124,1
336712,224908,-562272,-652,652926,-1622576,836,130,0
-81254,139105,-55903,1948,1625508,-668847,1046,130,0
-563,243,320,0,7032,9251,0,124,1
976336,-77353,-898334,649,-119190,-1351099,-1,130,0
559020,-208658,-352314,-1952,-598254,-1016990,-420,130,0
-501169,1058889,-556421,1299,1633258,-858629,1255,130,0
-140406,69552,72152,1298,817990,816105,1464,130,0
-36946,-33740,70686,0,-53984,113098,1,124,1
0,0,0,0,0,0,0,124,1
115704,14300,-127405,2599,170720,-1491656,417,130,0
233773,-165491,-68281,1,-214165,-88364,1,124,1
-317862,25350,294461,1949,117933,1351936,627,130,0
2164,3443,-5608,-1,9943,-16194,-1,124,1
1414,-707,-707,0,-8167,-8167,0,124,1
102053,554470,-655225,1298,1283858,-1516164,1046,130,0
-261310,-437467,702026,3249,-1011544,1616291,-211,130,0
-758579,-171607,931484,1298,-285093,1535434,417,130,0
165106,761828,-927585,-651,1258721,-1530827,836,130,0
-83854,979586,-896384,-652,1473221,-1347538,1046,130,0
1024438,-276911,-747529,-2,-426487,-1151891,-2,130,0
-1008188,824880,187207,3899,1253694,281112,1465,130,0
-273661,1023138,-748179,1298,1578167,-1155242,1256,130,0
24700,-930835,907433,1298,-1433213,1395716,-2,130,0
-68756,20082,48674,0,32132,77878,-1,124,1
-632,138,493,-1,261,935,-1,124,1
123504,-993888,873632,3248,-1497311,1314650,208,130,0
-827482,-194358,1026388,4548,-293472,1538367,627,130,0
-522,73,448,-1,2132,12958,0,124,1
4301,1030,-5332,-1,2976,-15397,-1,124,1
-599973,1069290,-467368,1949,1629697,-713255,1255,130,0
30000,30000,30000,90000,60000,60000,180000,124,1
-18862,-198133,216996,1,-256407,280818,1,124,1
-642875,-437467,1083590,3248,-659839,1623832,-1,130,0
130,-18,-112,0,-2132,-12958,0,124,1
30000,30000,30000,90000,60000,60000,180000,124,1
-1083591,586321,501168,3898,881670,750540,1255,130,0
1000387,-194358,-804081,1948,-301851,-1239031,-1,130,0
786529,222958,-1007538,1949,340812,-1553450,627,130,0
312011,656524,-969837,-1302,1083392,-1599953,417,130,0
155,482,-637,0,912,-1206,-1,124,1
736477,-1049790,316561,3248,-1592202,477807,-629,130,0
-5172,-4723,9896,1,-13496,28274,0,124,1
-9868,4261,5607,0,12176,16020,-1,124,1
0,0,0,0,0,0,0,124,1
54,86,-140,0,9943,-16194,-1,124,1
394564,-1074491,681875,1948,-1614406,1024111,-1,130,0
-137156,40951,99453,3248,466495,1122145,418,130,0
1033538,-810581,-222959,-2,-1217456,-334947,-420,130,0
211907,477767,-688376,1298,1106853,-1593250,626,130,0
784579,243759,-1027039,1299,369719,-1562248,417,130,0
-790430,1022488,-230759,1299,1558476,-354219,1255,130,0
300961,-315262,16250,1949,-1447876,68288,-630,130,0
-3999,5464,-1464,1,15777,-4227,1,124,1
109204,24050,-131305,1949,294309,-1538158,418,130,0
-256,-308,564,0,-8896,16311,0,124,1
9145,-1292,-7853,0,-3691,-22439,1,124,1
83853,-980237,898983,2599,-1472803,1348585,208,130,0
-456318,516119,-60453,-652,1495844,-178052,1256,130,0
1052389,-341263,-711127,-1,-519074,-1081508,208,130,0
-566,584,-17,1,1106,-32,1,124,1
65002,-642875,579171,1298,-1482648,1335388,-420,130,0
-642225,1050439,-406916,1298,1620690,-628628,1465,130,0
-426416,1053039,-624674,1949,1624251,-965041,1256,130,0
63702,269110,-330863,1949,1249085,-1536064,626,130,0
5818,-9845,4026,-1,-28129,11504,0,124,1
662374,403015,-1063440,1949,611450,-1616920,836,130,0
-44852,-588923,635073,1298,-1359059,1464633,-420,130,0
30000,30000,30000,90000,60000,60000,180000,124,1
-364664,555770,-190458,648,1607912,-552171,836,130,0
294461,-566172,272360,649,-1633469,786150,-212,130,0
237456,-151298,-86157,1,-195798,-111497,1,124,1
516769,569421,-1084241,1949,855905,-1632421,837,130,0
373764,-981537,608422,649,-1617968,1003793,-211,130,0
1260,-74,-1186,0,-854,-13698,1,124,1
915884,-135206,-781980,-1302,-224765,-1288467,-2,130,0
22750,109204,-131305,649,1265843,-1527056,627,130,0
-127405,986736,-857383,1948,1502757,-1305853,1256,130,0
566821,81903,-648075,649,190201,-1499615,418,130,0
1035488,-768329,-266510,649,-1167182,-406168,-1,130,0
110,-1276,1165,-1,-14742,13461,0,124,1
892483,89703,-980237,1949,132177,-1475317,836,130,0
-300962,-728678,1032888,3248,-1125078,1588221,-211,130,0
-375715,705276,-327613,1948,1632839,-760805,1256,130,0
276910,-1025089,750778,2599,-1578377,1154403,-630,130,0
-707877,345162,364013,1298,797671,835796,836,130,0
313961,-301612,-10401,1948,-1385662,-56768,-630,130,0
884,4396,-5281,-1,12694,-15249,0,124,1
-703327,1067990,-363364,1299,1607074,-548400,1255,130,0
943185,-212558,-731928,-1301,-351077,-1205725,-211,130,0
530419,530419,-1060190,648,815896,-1633050,627,130,0
739077,319161,-1056290,1948,477597,-1590946,626,130,0
204107,-353614,152105,2598,-1628022,693354,-630,130,0
-469,642,-172,1,1215,-325,1,124,1
-169999,232224,-62224,1,300525,-80525,1,124,1
0,0,0,0,0,0,0,124,1
-27059,-43045,70105,1,-68873,112169,1,124,1
-256760,-785880,1044589,1949,-1183312,1566855,-211,130,0
36946,-70686,33740,0,-113098,53984,-1,124,1
674075,400415,-1071891,2599,601186,-1615244,1046,130,0
-588273,-492719,1086840,5848,-743838,1631163,208,130,0
3325,2300,-5625,0,6643,-16244,-1,124,1
-263910,334112,-68903,1299,1549050,-323636,1465,130,0
30000,30000,30000,90000,60000,60000,180000,124,1
1036788,-711777,-325013,-2,-1096381,-500431,-631,130,0
30000,30000,30000,90000,60000,60000,180000,124,1
1012737,-166407,-844382,1948,-252415,-1271290,-211,130,0
-57853,-887284,949035,3898,-1367019,1457929,-211,130,0
-625974,29251,600622,3899,63889,1381262,208,130,0
-93604,-436817,529769,-652,-1260607,1529779,209,130,0
-991938,504418,488168,648,830978,802699,837,130,0
-90354,-893134,985436,1948,-1342092,1477829,-211,130,0
1077740,-652625,-423166,1949,-983684,-637635,-210,130,0
-991938,824230,169006,1298,1269404,256185,1046,130,0
-70492,40050,30441,-1,64081,48706,-1,124,1
41601,-509620,468667,648,-1470080,1352146,-211,130,0
1344,-294,-1050,0,-3396,-12138,0,124,1
559670,-208008,-352964,-1302,-596160,-1018876,-421,130,0
30000,30000,30000,90000,60000,60000,180000,124,1
180706,-354264,175506,1948,-1633887,806679,-629,130,0
-847632,1008837,-158606,2599,1520562,-241941,1256,130,0
91,47,-139,-1,5452,-16060,0,124,1
30000,30000,30000,90000,60000,60000,180000,124,1
-214509,1016638,-802781,-652,1549888,-1222483,1256,130,0
3325,2300,-5625,0,6643,-16244,-1,124,1
370513,-981537,611022,-2,-1617130,1008820,-421,130,0
115704,-130005,16900,2599,-1493750,174071,-211,130,0
-1040689,251559,791729,2599,377888,1187291,627,130,0
30000,30000,30000,90000,60000,60000,180000,124,1
-1062140,508319,555120,1299,781961,851715,1464,130,0
-103,620,-516,1,1175,-978,1,124,1
-522620,1082290,-559021,649,1633468,-843756,837,130,0
-1010138,822280,191107,3249,1249923,286768,1465,130,0
558,-355,-202,1,-10279,-5853,1,124,1
313961,-1056940,746877,3898,-1589898,1120888,-420,130,0
-706577,-248310,955535,648,-412033,1575025,418,130,0
-1015339,837881,180056,2598,1261444,268753,1255,130,0
444616,-989338,544720,-2,-1630745,899475,-211,130,0
0,0,0,0,0,0,0,124,1
703976,249609,-954236,-651,410566,-1573978,418,130,0
67602,-888584,822280,1298,-1466938,1356126,-211,130,0
-155,637,-482,0,1206,-912,1,124,1
3325,2300,-5625,0,6643,-16244,-1,124,1
-62403,139755,-75403,1949,1631373,-892773,1465,130,0
134,-105,-29,0,-12138,-3396,0,124,1
-1344,1050,294,0,12138,3396,0,124,1
1082290,-581122,-501169,-1,-877063,-754731,-2,130,0
-843732,-133255,980886,3899,-208635,1507155,627,130,0
-590873,-390665,984786,3248,-647690,1622365,-211,130,0
240416,-120208,-120208,0,-155563,-155563,0,124,1
-132605,104653,30551,2599,1217874,334737,1256,130,0
-460218,-618174,1081640,3248,-933201,1627812,418,130,0
458917,-519370,61102,649,-1495635,178051,-630,130,0
301,-663,362,0,-1256,685,0,124,1
-108555,-880133,991937,3249,-1325334,1489769,-421,130,0
856082,151455,-1004288,3249,224345,-1513022,417,130,0
36401,286010,-319812,2599,1328056,-1487257,1045,130,0
604522,-1074491,471917,1948,-1630117,716606,-211,130,0
-999,-366,1366,1,-4227,15777,1,124,1
88,-528,439,-1,-15249,12694,0,124,1
-427717,532369,-104654,-2,1542975,-305202,1674,130,0
66302,75402,-139106,2598,886278,-1630955,626,130,0
880132,110504,-990638,-2,164436,-1489142,627,130,0
0,0,0,0,0,0,0,124,1
-903534,-63703,972436,5199,-99081,1461490,627,130,0
-1073841,497918,578521,2598,755777,876852,1255,130,0
445266,-989338,544720,648,-1630745,899056,-1,130,0
784579,258709,-1040689,2599,385848,-1567066,417,130,0
-27059,-43045,70105,1,-68873,112169,1,124,1
749478,-937336,188507,649,-1544862,312323,-212,130,0
700726,-438117,-261310,1299,-1011754,-604958,-421,130,0
408215,295761,-702677,1299,684766,-1626137,837,130,0
356863,-1043940,689675,2598,-1606656,1060350,-421,130,0
-5547,63822,-58274,1,102115,-93239,0,124,1
-381565,-666275,1049139,1299,-1027045,1613149,-629,130,0
143005,209307,-348414,3898,971953,-1622366,628,130,0
1017288,-836582,-178757,1949,-1260398,-269801,-211,130,0
137,-40,-97,0,-4639,-11243,0,124,1
1205,-1242,37,0,-14354,427,0,124,1
-967237,912634,55252,649,1373093,80646,1464,130,0
384814,596722,-981537,-1,984312,-1620691,627,130,0
74292,-235162,160869,-1,-304328,208184,-1,124,1
728027,321112,-1047190,1949,487023,-1593250,626,130,0
432266,98153,-531720,-1301,288234,-1536273,-1,130,0
1041989,-779380,-262610,-1,-1175352,-394647,-2,130,0
-977637,82553,899633,4549,122541,1349213,417,130,0
402365,141705,-544721,-651,411194,-1574188,417,130,0
30000,30000,30000,90000,60000,60000,180000,124,1
709176,360763,-1067340,2599,540649,-1604771,627,130,0
88,-528,439,-1,-15249,12694,0,124,1
-8008,-1034,9043,1,-2956,25838,0,124,1
-211908,-140406,352963,649,-641615,1621528,209,130,0
1344,-294,-1050,0,-3396,-12138,0,124,1
977636,-364014,-616224,-2602,-600978,-1014896,-421,130,0
377664,-1061490,687075,3249,-1611055,1042126,-421,130,0
-943836,934084,12350,2598,1406818,16129,1255,130,0
-1044590,273010,776779,5199,408262,1165924,1046,130,0
-5379,4203,1176,0,12138,3396,0,124,1
-341263,246359,96853,1949,1145187,436541,1047,130,0
0,0,0,0,0,0,0,124,1
-11061,66014,-54952,1,105622,-87924,0,124,1
-6429,-3304,9733,0,-9441,27810,0,124,1
891833,76052,-963987,3898,114791,-1467985,837,130,0
-709177,1036138,-325663,1298,1598276,-503992,1674,130,0
-130005,17550,114404,1949,217223,1293284,418,130,0
-52002,139105,-85804,1299,1619014,-998138,836,130,0
145605,-919785,776129,1949,-1518677,1280716,-210,130,0
239675,-103501,-136173,1,-133943,-176224,0,124,1
1409,-801,-608,0,-9251,-7032,0,124,1
-724778,-338663,1066039,2598,-511533,1599114,-2,130,0
63003,-3700,-59302,1,-5921,-94884,0,124,1
103,-620,516,-1,-1175,978,-1,124,1
60290,-62141,1850,-1,-99426,2961,0,124,1
-469968,1080340,-609723,649,1629278,-919795,1255,130,0
-280161,325012,-41602,3249,1505480,-202770,1256,130,0
-640925,-437467,1082940,4548,-659630,1623832,-1,130,0
30000,30000,30000,90000,60000,60000,180000,124,1
-1004938,862582,142355,-1,1297264,211357,627,130,0
30000,30000,30000,90000,60000,60000,180000,124,1
-371814,976986,-609073,-3901,1618176,-1004422,627,130,0
-429017,1053039,-623374,648,1624670,-962527,1047,130,0
-566,-17,584,1,-32,1106,1,124,1
0,0,0,0,0,0,0,124,1
74292,-235162,160869,-1,-304328,208184,-1,124,1
794979,-1027689,234008,1298,-1558896,355684,-211,130,0
875582,-959436,87103,3249,-1476155,131548,-631,130,0
-887934,63052,826830,1948,102013,1360944,628,130,0
0,0,0,0,0,0,0,124,1
-3788,-6026,9814,0,-17218,28042,1,124,1
0,8573,-8573,0,24494,-24494,0,124,1
967886,-112455,-855433,-2,-175120,-1318422,-2,130,0
353613,-1043290,692275,2598,-1605609,1064121,-421,130,0
1003637,-142356,-860633,648,-214919,-1294542,208,130,0
846331,19500,-867133,-1302,31839,-1429652,417,130,0
707226,-345163,-361414,649,-796206,-837053,-420,130,0
516119,570071,-1083591,2599,856743,-1632212,1046,130,0
349713,-230109,-118955,649,-1052182,-556360,-630,130,0
768328,281460,-1049140,648,419783,-1576492,418,130,0
50701,-328913,280810,2598,-1514488,1287838,-420,130,0
918,472,-1390,0,5452,-16060,0,124,1
0,0,0,0,0,0,0,124,1
-328263,50701,278860,1298,237960,1280506,626,130,0
-831,1406,-575,0,16244,-6643,1,124,1
911334,-791730,-120255,-651,-1306482,-196067,-421,130,0
-1414,707,707,0,8167,8167,0,124,1
213858,135855,-349064,649,639310,-1620900,836,130,0
137155,-106604,-27952,2599,-1214314,-339137,-421,130,0
-100104,-36402,137805,1299,-416013,1575653,208,130,0
74292,-235162,160869,-1,-304328,208184,-1,124,1
703976,-297062,-406266,648,-685395,-941161,-211,130,0
-606473,615573,-7801,1299,1426508,-23461,1046,130,0
223608,-947086,724127,649,-1562248,1194832,-420,130,0
-296412,963986,-668876,-1302,1594715,-1104759,1046,130,0
205407,-352964,150805,3248,-1627394,688327,-630,130,0
222308,784579,-1009488,-2601,1210333,-1554916,837,130,0
1075,257,-1333,-1,2976,-15397,-1,124,1
105953,-345813,242459,2599,-1592202,1113347,-839,130,0
-241160,-709827,952935,1948,-1173885,1570835,-1,130,0
776,8158,-8935,-1,23309,-25528,0,124,1
5656,-2828,-2828,0,-8167,-8167,0,124,1
-284711,-751429,1042639,6499,-1145397,1581728,-1,130,0
75402,65652,-139106,1948,779866,-1632421,1046,130,0
0,0,0,0,0,0,0,124,1
-603873,-450467,1059539,5199,-697335,1627812,208,130,0
0,0,0,0,0,0,0,124,1
494018,590222,-1084891,-651,886278,-1630955,836,130,0
-176157,-376365,554470,1948,-1088002,1599114,-421,130,0
891183,52651,-942536,1298,79599,-1452275,207,130,0
30000,30000,30000,90000,60000,60000,180000,124,1
-83854,524569,-442017,-1302,1520352,-1277365,836,130,0
301611,-1044590,746877,3898,-1586128,1133037,-421,130,0
0,0,0,0,0,0,0,124,1
0,0,0,0,0,0,0,124,1
686425,-195658,-491419,-652,-448482,-1135971,-631,130,0
5656,-2828,-2828,0,-8167,-8167,0,124,1
256759,-566172,310061,648,-1630955,895495,-211,130,0
-117655,661724,-543421,648,1532292,-1256627,1465,130,0
-686426,191757,495318,649,442406,1140369,627,130,0
312011,391964,-704627,-652,907854,-1629489,836,130,0
5656,-2828,-2828,0,-8167,-8167,0,124,1
-1058240,750128,308111,-1,1127800,460002,1046,130,0
-21850,-47314,69165,1,-75703,110664,0,124,1
-598023,1069940,-469968,1949,1629697,-717235,1046,130,0
-11061,66014,-54952,1,105622,-87924,0,124,1
-707877,-358164,1071890,5849,-541487,1605398,-1,130,0
314611,-300962,-11051,2598,-1384196,-59700,-420,130,0
61102,-967887,911334,4549,-1457093,1368275,-212,130,0
336062,-269111,-65653,1298,-1234214,-310020,-630,130,0
-336713,-226209,562921,-1,-652927,1622994,-211,130,0
-1083591,512219,574621,3249,770650,862608,1465,130,0
296411,754028,-1051090,-651,1136389,-1584033,1046,130,0
178106,374414,-555121,-2601,1085068,-1599534,208,130,0
-44852,-588273,635073,1948,-1358640,1464842,-1,130,0
443966,624673,-1068641,-2,951005,-1624880,836,130,0
30000,30000,30000,90000,60000,60000,180000,124,1
30000,30000,30000,90000,60000,60000,180000,124,1
986736,-103354,-882084,1298,-158781,-1328267,208,130,0
-295,-269,565,1,-7793,16328,1,124,1
-893134,-87104,982836,2598,-132387,1476154,418,130,0
-26651,-926285,954885,1949,-1394879,1434050,-629,130,0
-625974,27301,600622,1949,61794,1382729,627,130,0
1084240,-471268,-612323,649,-709275,-919376,-1,130,0
116354,230108,-345163,1299,1070824,-1603304,418,130,0
-254160,-86454,341912,1298,-396742,1570626,627,130,0
-223609,347113,-122205,1299,1611682,-572908,1046,130,0
-130,18,112,0,2132,12958,0,124,1
-100754,-555771,658474,1949,-1283649,1516372,-211,130,0
132,410,-542,0,11848,-15661,0,124,1
-746228,936035,-189158,649,1545908,-314210,1255,130,0
143005,-81254,-58503,3248,-931526,-696288,-421,130,0
509619,-681226,174856,3249,-1572093,400302,-420,130,0
336712,726727,-1063440,-1,1091771,-1597858,627,130,0
140,-60,-80,0,-7032,-9251,0,124,1
35101,-135856,104003,3248,-1566437,1184568,-629,130,0
1043939,-778080,-263260,2599,-1174095,-396742,-421,130,0
295,-565,269,-1,-16328,7793,-1,124,1
10400,-617524,609072,1948,-1425672,1403257,-421,130,0
-332,562,-230,0,16244,-6643,1,124,1
182813,43812,-226626,-1,56698,-293281,-1,124,1
-843732,-131305,980236,5199,-206331,1506527,1046,130,0
130654,-351014,222308,1948,-1615244,1019503,-630,130,0
147555,-922385,774829,-1,-1520353,1277573,-211,130,0
12350,-128705,118304,1949,-1472384,1349004,-1,130,0
0,0,0,0,0,0,0,124,1
649374,-86454,-564872,-1952,-197533,-1305225,-420,130,0
330212,-564222,234658,648,-1626346,677015,-420,130,0
670175,378314,-1046540,1949,580448,-1611893,626,130,0
506368,-1060840,557720,3248,-1633469,856952,-840,130,0
537,-607,69,-1,-1149,131,0,124,1
401715,143005,-545371,-651,414546,-1575235,-1,130,0
1038088,-709827,-326963,1298,-1093448,-504201,-211,130,0
0,0,0,0,0,0,0,124,1
30000,30000,30000,90000,60000,60000,180000,124,1
-708527,-358164,1071240,4549,-541278,1605189,-211,130,0
-145606,1003637,-856733,1298,1512392,-1290771,1046,130,0
521969,-451767,-70203,-1,-1302921,-202142,-631,130,0
295,-565,269,-1,-16328,7793,-1,124,1
559020,-358164,-201508,-652,-1033539,-578983,-421,130,0
711776,-1039389,329562,1949,-1598487,506295,-630,130,0
-505719,34451,473217,1949,98661,1362619,417,130,0
30000,30000,30000,90000,60000,60000,180000,124,1
-879483,-111155,994537,3899,-167788,1491026,836,130,0
-989988,826180,165756,1948,1272127,252414,1255,130,0
30000,30000,30000,90000,60000,60000,180000,124,1
-37609,224447,-186838,0,290462,-241791,1,124,1
306161,2600,-306162,2599,16338,-1422320,208,130,0
-8451,-852832,861932,649,-1408285,1421272,-210,130,0
0,0,0,0,0,0,0,124,1
0,0,0,0,0,0,0,124,1
787179,240509,-1026389,1299,363225,-1560153,836,130,0
-116355,661074,-543421,1298,1531873,-1257256,1255,130,0
-44852,950335,-905484,-1,1448084,-1378540,1255,130,0
380914,666274,-1046540,648,1024530,-1613359,836,130,0
-563572,323712,241159,1299,932991,695449,1256,130,0
668875,-139756,-529770,-651,-319656,-1226882,417,130,0
1205,-1242,37,0,-14354,427,0,124,1
-699427,438116,263259,1948,1013847,602652,1045,130,0
964636,-291861,-674076,-1301,-481788,-1110834,-630,130,0
30000,30000,30000,90000,60000,60000,180000,124,1
-100,-36,136,0,-4227,15777,0,124,1
949685,-19501,-926935,3249,-33097,-1397602,-1,130,0
838531,176806,-1015339,-2,265611,-1528104,208,130,0
505,121,-626,0,229,-1186,0,124,1
-89054,-807981,898333,1298,-1335808,1482228,-211,130,0
492068,191107,-685126,-1951,444710,-1583195,208,130,0
-4000,-1464,5464,0,-4227,15777,0,124,1
-216,-344,560,0,-9943,16194,1,124,1
-1012738,167706,848931,3899,249900,1273174,835,130,0
460217,621423,-1079691,1949,934667,-1626975,837,130,0
-730628,1058239,-326963,648,1595762,-493937,1046,130,0
251559,-1041990,793029,2598,-1564343,1190223,-212,130,0
41562,-70323,28760,-1,-112517,46016,-1,124,1
-47452,325662,-276911,1299,1514487,-1287420,836,130,0
295,-565,269,-1,-16328,7793,-1,124,1
-1064090,354263,714376,4549,530594,1072709,836,130,0
-124805,117654,8450,1299,1373721,79180,1255,130,0
648724,-1053040,406915,2599,-1619853,625485,-421,130,0
-771579,-276261,1052389,4549,-417061,1576072,208,130,0
-161207,-764429,927584,1948,-1262283,1528941,-1,130,0
-1064740,356213,712426,3899,533736,1070405,837,130,0
-505069,679275,-172257,1949,1572720,-402607,1255,130,0
-657825,-418616,1079690,3249,-631561,1620271,208,130,0
-1006888,148855,861932,3899,221831,1290770,836,130,0
533019,-1075791,546670,3898,-1633678,829511,417,130,0
0,0,0,0,0,0,0,124,1
-370514,-183957,556420,1949,-534365,1603722,-211,130,0
969186,-915235,-52652,1299,-1373513,-79391,-630,130,0
-1073191,571371,507018,5198,867635,765413,1465,130,0
-214212,12582,201630,0,16283,260933,0,124,1
-665625,1073190,-405616,1949,1617967,-612708,837,130,0
-936686,-3251,945135,5198,-7542,1418339,626,130,0
768328,-1053690,287960,2598,-1580053,430675,-2,130,0
-134,105,29,0,12138,3396,0,124,1
-459568,-597373,1059539,2598,-921680,1628859,-1,130,0
-666275,1073190,-404966,1949,1617967,-612080,1255,130,0
137,-40,-97,0,-4639,-11243,0,124,1
-878183,834631,43551,-1,1378539,70592,1255,130,0
312661,391964,-703977,648,907016,-1629698,208,130,0
-42252,137155,-93604,1299,1598276,-1093029,1046,130,0
-1072541,568771,508969,5199,863865,769602,1674,130,0
-46802,325662,-277561,1299,1513649,-1288886,1465,130,0
-256,564,-308,0,16311,-8896,0,124,1
-7527,9331,-1804,0,26661,-5154,0,124,1
-783280,-257410,1045239,4549,-389620,1568531,417,130,0
-114405,-232709,349063,1949,-1071453,1603513,-420,130,0
-1075791,392614,684475,1298,587989,1025997,836,130,0
-223609,945135,-722178,-652,1563294,-1192319,627,130,0
-182813,-43812,226626,1,-56698,293281,1,124,1
60290,-62141,1850,-1,-99426,2961,0,124,1
30000,30000,30000,90000,60000,60000,180000,124,1
4000,1464,-5464,0,4227,-15777,0,124,1
-399,546,-146,1,15777,-4227,1,124,1
-911335,790429,120904,-2,1305433,198580,1046,130,0
541,860,-1402,-1,9943,-16194,-1,124,1
-49402,326312,-276261,649,1515953,-1284906,836,130,0
-899634,973736,-72153,1949,1467565,-111859,1046,130,0
214212,-201630,-12582,0,-260933,-16283,0,124,1
-938636,920434,20800,2598,1400953,28278,1465,130,0
0,0,0,0,0,0,0,124,1
192407,-999088,809280,2599,-1538787,1244477,-1,130,0
219708,787829,-1007538,-1,1214313,-1553031,837,130,0
-8451,126104,-115705,1948,1471755,-1349633,837,130,0
-48102,-464118,512219,-1,-1340207,1478877,-420,130,0
-537,-69,607,1,-131,1149,0,124,1
-193058,-828132,1023788,2598,-1246782,1537320,208,130,0
537,-607,69,-1,-1149,131,0,124,1
-1320,5423,-4103,0,15661,-11848,0,124,1
-9145,1292,7853,0,3691,22439,-1,124,1
-323713,283410,42251,1948,1312346,187268,1465,130,0
-655875,556420,101403,1948,1286371,229163,1046,130,0
30000,30000,30000,90000,60000,60000,180000,124,1
255459,83853,-338013,1299,395693,-1569998,-2,130,0
23400,-929535,907433,1298,-1432794,1396135,-211,130,0
-5656,2828,2828,0,8167,8167,0,124,1
-333463,267160,68902,2599,1234003,310647,1464,130,0
30000,30000,30000,90000,60000,60000,180000,124,1
-791080,-215809,1010787,3898,-334738,1551773,417,130,0
-1084241,491418,596072,3249,737343,893819,1045,130,0
49401,913284,-961387,1298,1376863,-1449342,1045,130,0
143005,-63053,-77353,2599,-710113,-918538,-1,130,0
1033538,-260010,-770929,2599,-396532,-1173676,-1,130,0
1076440,-410166,-664975,1299,-617735,-1000652,-420,130,0
30000,30000,30000,90000,60000,60000,180000,124,1
56124,174391,-230515,0,225683,-298314,0,124,1
-204988,211281,-6293,0,273423,-8144,0,124,1
-1076441,414715,665624,3898,622971,996252,627,130,0
0,0,0,0,0,0,0,124,1
-646,457,188,-1,866,357,0,124,1
57206,-64597,7391,0,-103355,11826,0,124,1
-139,88,50,-1,10279,5853,-1,124,1
63702,-969187,909384,3899,-1459187,1365761,-2,130,0
-314612,-390015,707226,2599,-904085,1630116,-211,130,0
601272,454367,-1056290,-651,699219,-1627603,627,130,0
-510920,987386,-477768,-1302,1633677,-789503,836,130,0
-965287,290560,676025,1298,477807,1113975,627,130,0
579821,-643525,65652,1948,-1483277,148725,-421,130,0
78002,-338663,262609,1948,-1558687,1203001,-421,130,0
-1024439,824880,202807,3248,1240706,301012,1465,130,0
35101,-135856,104653,3898,-1565390,1187291,-839,130,0
-144306,917834,-775480,-1952,1518886,-1280298,627,130,0
354913,-159906,-193058,1949,-732317,-898429,-630,130,0
676025,-520670,-153406,1949,-1202374,-356523,-630,130,0
-139756,-211908,352963,1299,-974258,1622365,-2,130,0
457617,530419,-988688,-652,876852,-1631583,418,130,0
0,0,0,0,0,0,0,124,1
-768329,1015988,-246360,1299,1567274,-383545,1255,130,0
27951,-931485,906133,2599,-1434469,1394040,-211,130,0
632,-493,-138,1,-935,-261,1,124,1
522619,464117,-988688,-1952,767088,-1632212,417,130,0
-139106,88403,51351,648,1033119,579820,1256,130,0
-1067340,640273,430966,3899,972791,650831,1465,130,0
578521,-644175,67602,1948,-1485581,154381,-211,130,0
710476,-1040039,330212,649,-1598906,508599,-631,130,0
39651,-955536,921734,5849,-1442010,1386080,-420,130,0
299011,267810,-565522,1299,773163,-1632212,417,130,0
-125617,240333,-114716,0,311020,-148456,1,124,1
-725428,-320463,1051739,5848,-489119,1594296,208,130,0
30000,30000,30000,90000,60000,60000,180000,124,1
-57206,64597,-7391,0,103355,-11826,0,124,1
-173557,-841132,1018588,3899,-1265425,1527474,-2,130,0
365313,691625,-1056290,648,1052390,-1607494,627,130,0
-98804,135205,-35752,649,1578376,-423345,1045,130,0
927584,29251,-954236,2599,40637,-1434260,208,130,0
988687,-504419,-486219,-1951,-832654,-800605,-420,130,0
705276,-393265,-312012,-1,-907017,-722681,-1,130,0
193707,-999738,807980,1949,-1540044,1242173,-839,130,0
-1038739,709826,330212,1299,1093447,504829,1256,130,0
-21850,69165,-47314,1,110664,-75703,0,124,1
141313,-239099,97786,0,-309422,126546,-1,124,1
0,0,0,0,0,0,0,124,1
-86454,-810581,897683,648,-1338321,1480343,-1,130,0
-1018589,190457,833981,5849,283207,1251808,837,130,0
960735,-687726,-273661,-652,-1134505,-450576,-421,130,0
4823,-4971,148,0,-14354,427,0,124,1
-229459,1032238,-802781,-2,1555963,-1209286,1047,130,0
847631,16900,-865833,-1302,27650,-1427976,-2,130,0
0,0,0,0,0,0,0,124,1
0,0,0,0,0,0,0,124,1
656,-238,-418,0,-451,-792,0,124,1
-68756,48674,20082,0,77878,32132,-1,124,1
-558371,358813,198907,-651,1037727,574164,1046,130,0
378314,-707877,332812,3249,-1632840,763946,-630,130,0
588922,393264,-982187,-1,648108,-1621948,626,130,0
484918,11700,-496619,-1,35400,-1431746,-2,130,0
1409,-608,-801,0,-7032,-9251,0,124,1
-749479,1053689,-302262,1948,1587174,-457070,1465,130,0
-390665,-593473,982836,-1302,-979704,1621528,-420,130,0
-369864,1066039,-695527,648,1609169,-1049668,837,130,0
83,57,-140,0,6643,-16244,-1,124,1
3900,939285,-942536,649,1412264,-1416874,1045,130,0
649374,321762,-970487,649,528290,-1602257,418,130,0
-603223,-453067,1060189,3899,-700268,1628231,208,130,0
734527,-1060190,328262,2599,-1595344,493308,-210,130,0
-139106,50051,91003,1948,586732,1026625,417,130,0
-301,-362,663,0,-685,1256,0,124,1
0,0,0,0,0,0,0,124,1
-99,136,-36,1,15777,-4227,1,124,1
-656,238,418,0,451,792,0,124,1
-7000,-2562,9562,0,-7320,27320,0,124,1
-46152,950985,-904834,-1,1449341,-1377283,837,130,0
-1548,9241,-7693,0,26405,-21981,0,124,1
609722,-617524,10400,2598,-1424624,19271,-839,130,0
-262610,334762,-69553,2599,1550726,-329292,1255,130,0
-140406,61102,81253,1949,709902,919375,836,130,0
-244410,341262,-95554,1298,1585079,-448900,837,130,0
-488169,1083590,-595423,-2,1631373,-895077,1256,130,0
139,-50,-88,1,-5853,-10279,1,124,1
1056289,-707227,-347764,1298,-1073129,-529966,-1,130,0
367,188,-556,-1,5452,-16060,0,124,1
-1034189,809280,224908,-1,1217664,334946,1255,130,0
873632,-960086,87753,1299,-1477411,134271,-630,130,0
1080990,-633774,-446567,649,-953939,-671570,-420,130,0
-692926,956835,-264560,-651,1582147,-436961,1255,130,0
842431,157955,-997788,2598,239008,-1518049,1046,130,0
-1082941,582421,504418,3898,876224,756405,1465,130,0
59802,885983,-945786,-1,1366809,-1457930,837,130,0
1082290,-581122,-501169,-1,-877482,-754312,-212,130,0
-676026,-393265,1075140,5849,-597207,1615453,418,130,0
-956836,922384,36401,1949,1388803,51320,1255,130,0
948385,-15601,-929535,3249,-27022,-1400325,418,130,0
-685776,191757,495318,1299,443034,1139950,627,130,0
731277,299661,-1029639,1299,460839,-1586966,417,130,0
-329563,51351,278860,648,240474,1278830,627,130,0
-330,-1025,1355,0,-11848,15661,0,124,1
1043939,-270411,-772879,649,-409101,-1164669,207,130,0
-263910,334112,-69553,649,1549888,-326568,1675,130,0
-11061,66014,-54952,1,105622,-87924,0,124,1
794329,-1027689,234658,1298,-1559315,356731,-2,130,0
-82554,-57853,141705,1298,-659630,1623622,-2,130,0
1396,-506,-889,1,-5853,-10279,1,124,1
-4551,-303562,310711,2598,-1402001,1426927,-2,130,0
458267,529119,-988688,-1302,874967,-1631793,417,130,0
-971787,64352,911334,3899,94262,1365133,627,130,0
-588273,-394565,984136,1298,-653974,1622994,-211,130,0
1078390,-432917,-643525,1948,-654393,-968812,-2,130,0
-844382,-132605,980236,3249,-206541,1506527,836,130,0
30000,30000,30000,90000,60000,60000,180000,124,1
0,0,0,0,0,0,0,124,1
-967237,913284,52651,-1302,1375397,76667,1465,130,0
1083590,-470618,-612973,-1,-708647,-920214,-211,130,0
57206,-64597,7391,0,-103355,11826,0,124,1
-722178,-339963,1066039,3898,-514046,1599533,-1,130,0
297061,-965937,671475,2599,-1593878,1106853,-420,130,0
1016638,-835932,-179407,1299,-1259769,-270639,-211,130,0
306811,1300,-304862,3249,10054,-1419387,-1,130,0
559020,-359464,-200208,-652,-1036262,-575631,-630,130,0
497918,589572,-1084891,2599,883346,-1631164,627,130,0
-790430,1023788,-231409,1949,1558895,-355057,1255,130,0
-5226,738,4487,-1,2132,12958,0,124,1
700076,-439417,-260660,-1,-1013220,-603072,-420,130,0
-891184,-53953,947735,2598,-84837,1454997,627,130,0
-347,664,-317,0,1258,-600,1,124,1
-705277,295761,410815,1299,682462,944302,1046,130,0
1018588,-185257,-831382,1949,-281951,-1252019,417,130,0
314611,655224,-969837,-2,1080669,-1600791,627,130,0
30000,30000,30000,90000,60000,60000,180000,124,1
-918485,917834,650,-1,1416035,-2095,1046,130,0
257409,786529,-1041990,1948,1181635,-1567066,1046,130,0
-74292,-160869,235162,1,-208184,304328,1,124,1
-83,-57,140,0,-6643,16244,1,124,1
523269,-450467,-70853,1949,-1301664,-204655,-1258,130,0
332,-562,230,0,-16244,6643,-1,124,1
0,0,0,0,0,0,0,124,1
1073840,-392615,-680576,649,-590713,-1023484,-210,130,0
60290,-62141,1850,-1,-99426,2961,0,124,1
299661,-967237,668875,1299,-1594716,1103502,-420,130,0
0,0,0,0,0,0,0,124,1
-854783,-146906,1006887,5198,-223717,1513230,418,130,0
469,-642,172,-1,-1215,325,-1,124,1
796279,-1038089,243759,1949,-1562248,366577,-211,130,0
-139106,88403,52001,1298,1032281,580448,627,130,0
-205408,-807981,1019238,5849,-1231490,1545489,418,130,0
1018588,-770929,-244410,3249,-1187920,-377470,-630,130,0
668875,-140406,-529770,-1301,-320913,-1226254,207,130,0
-1073841,572671,505718,4548,869102,763737,1256,130,0
-141056,70202,72152,1298,819457,814010,836,130,0
132,-542,410,0,-15661,11848,0,124,1
30000,30000,30000,90000,60000,60000,180000,124,1
133905,-989988,859982,3899,-1504224,1304595,207,130,0
5547,58274,-63822,-1,93239,-102115,0,124,1
-484269,-9751,495968,1948,-28698,1429022,836,130,0
-4576,5167,-591,0,14922,-1707,1,124,1
-37609,224447,-186838,0,290462,-241791,1,124,1
103,516,-620,-1,978,-1175,-1,124,1
1064739,-349714,-712427,2598,-530595,-1072501,-212,130,0
928884,24700,-952286,1298,34981,-1431537,207,130,0
5226,-4487,-738,1,-12958,-2132,0,124,1
-1344,1050,294,0,12138,3396,0,124,1
30000,30000,30000,90000,60000,60000,180000,124,1
-1007538,148205,862582,3249,220993,1291399,1046,130,0
963986,-289261,-676026,-1301,-477389,-1113976,-211,130,0
703976,-297712,-405616,648,-686652,-939904,-211,130,0
83,57,-140,0,6643,-16244,-1,124,1
-381565,-663675,1049139,3899,-1024741,1613987,-1,130,0
1396,-889,-506,1,-10279,-5853,1,124,1
0,0,0,0,0,0,0,124,1
-81904,-57853,142355,2598,-664448,1624041,-211,130,0
-745578,935385,-190458,-651,1546117,-315047,1255,130,0
-565,282,282,-1,8167,8167,0,124,1
126754,-120255,-6501,-2,-1370790,-84418,-630,130,0
-26651,930184,-904184,-651,1434468,-1394041,1046,130,0
-120,-3,124,1,-427,14354,0,124,1
-662,376,286,0,712,541,-1,124,1
386114,594772,-981537,-651,981798,-1621110,417,130,0
-219059,-341263,562271,1949,-987245,1620690,-1,130,0
-211908,-139756,352963,1299,-639311,1621318,-211,130,0
0,0,0,0,0,0,0,124,1
12350,-128055,118954,3249,-1473012,1347956,-1,130,0
-323713,284060,41601,1948,1315697,181403,1255,130,0
-91004,-46802,140405,2599,-545048,1605608,-210,130,0
-233359,-113105,348413,1949,-520121,1600580,-421,130,0
963986,-290561,-674726,-1301,-480112,-1111882,-421,130,0
563,-320,-243,0,-9251,-7032,0,124,1
1748,-5533,3785,0,-15977,10929,-1,124,1
-550571,165106,386764,1299,476969,1114394,417,130,0
-46802,325662,-276911,1949,1513649,-1289095,1256,130,0
-239859,-710477,952935,2599,-1173676,1570835,-211,130,0
-137,97,40,0,11243,4639,0,124,1
-178757,352963,-171607,2599,1633677,-801443,836,130,0
-141313,-97786,239099,0,-126546,309422,1,124,1
-73,141,-67,1,16328,-7793,1,124,1
0,0,0,0,0,0,0,124,1
-273661,1023138,-748179,1298,1578167,-1154823,1047,130,0
30000,30000,30000,90000,60000,60000,180000,124,1
-110,1276,-1165,1,14742,-13461,0,124,1
-63053,139105,-75403,649,1631582,-889422,1045,130,0
5500,-1606,-3893,1,-4639,-11243,0,124,1
195007,-1000388,807980,2599,-1540463,1241544,-630,130,0
452416,-1080341,631173,3248,-1626346,948701,-1,130,0
-338663,-723478,1067339,5198,-1089258,1598905,-1,130,0
44851,92953,-136506,1298,1089676,-1598277,1046,130,0
109204,-967237,860632,2599,-1490818,1324286,-421,130,0
9414,-7356,-2058,0,-21019,-5880,0,124,1
16507,-67798,51291,0,-108478,82066,-1,124,1
-1073841,568121,509619,3899,863446,770021,1674,130,0
-549271,391964,157305,-2,1134504,451204,1047,130,0
969836,-59153,-908735,1948,-91540,-1366391,208,130,0
131954,-113755,-16901,1298,-1296636,-212196,-420,130,0
431616,-1055640,627273,3249,-1624252,963364,-421,130,0
22750,-317212,297061,2599,-1461491,1362829,-210,130,0
-171607,-841782,1017938,4549,-1266682,1526636,-2,130,0
451766,244409,-695527,648,565576,-1609379,418,130,0
137155,405615,-544071,-1301,1176398,-1569579,837,130,0
1074490,-684476,-387415,2599,-1030187,-582963,-420,130,0
-470,-172,642,0,-325,1215,0,124,1
30000,30000,30000,90000,60000,60000,180000,124,1
325662,-286661,-38352,649,-1315070,-182242,-421,130,0
-387415,-594773,982836,648,-982008,1621528,-1,130,0
30000,30000,30000,90000,60000,60000,180000,124,1
-214212,12582,201630,0,16283,260933,0,124,1
-956186,923684,33801,1299,1390689,47550,1256,130,0
30000,30000,30000,90000,60000,60000,180000,124,1
1073840,-572022,-501169,649,-869312,-762900,-211,130,0
344512,-248960,-94254,1298,-1144140,-438008,-839,130,0
92003,-238359,146356,0,-308465,189402,0,124,1
-757929,-172907,932134,1298,-286350,1535853,626,130,0
5379,-4203,-1176,0,-12138,-3396,0,124,1
549270,-1087491,541470,3249,-1634097,812125,-630,130,0
-1074491,688375,388714,2598,1032700,580029,1046,130,0
0,0,0,0,0,0,0,124,1
-301,-362,663,0,-685,1256,0,124,1
569421,-1087491,522619,4549,-1633469,783008,-212,130,0
256,308,-564,0,8896,-16311,0,124,1
-566172,247659,318511,-2,715139,914557,836,130,0
1077740,-430967,-644825,1948,-652298,-970697,-1,130,0
-1051740,648724,406265,3249,997508,622133,1255,130,0
50051,912634,-962037,648,1376026,-1450180,1256,130,0
917184,-139756,-779380,-1952,-230420,-1284696,209,130,0
